Acorns Grow, Inc.|acorns.com
AMEX - Global Business Travel Vulnerability Disclosure Program|amexgbt.com,amexglobalbusinesstravel.com,banks-sadler.com,bienquiries.co.uk,ebrdevents.co.uk,gbt-invoicing.com,gbtad.com,gbtexternal.com,gbtnta.com,gbtspain.com,hrgnorthamerica.com,hrgworldwide.com,itq.in,kds.com,lawyerstravel.com,meetingsexpreess.com,meetingsexpress.com,meetingssource.com,miclientool.com,mieventool.com,miwebtool.com,mykds.com,mytravelsolution.com,ovationtravel.com,pre-gbtspain.com,sourcingcenteramexgbt.com,supplierstool.com,uathrg-isuite.com,uathrgisuite.com,winnerscircleregistration.com,wovationtravel.com
Arrow Electronics VDP|Datasheet,aepetsche.com,arrow.cn,arrow.com,aspencore.com,chip1stop.com,eetimes.com,einfochips.com,elektroda.pl,immixgroup.com,powerandsignal.com,richardsonrfpd.com,siliconexpert.com,transim.com,verical.com,xsp.arrow.com
Aruba Networks Infrastructure Public Program|arubanetworks.com
Asana|app.asana.com,asana.biz,asana.com,asana.plus
Atlassian|atlassian.com,atlassian.net,atlastunnel.com
BigCommerce|bigcommerce.com,bigcommerce.net
Binance|binance.co.ug,binance.com,binance.je,binance.org,binance.sg,binance.us,bnbchain.org
Bitdefender|bitdefender.com,bitdefender.net
BitDiscovery|bitdiscovery.com
Bitget|bitget.com
Caffeine|caffeine.tv,rtcdn.caffeine.tv
Canva|canva-apps.cn,canva-apps.com,canva.cn,canva.com,canva.tech
Cash App|cash.app,cashstaging.app,joinverse.com,verse.events,verse.me
Cisco Meraki|cisco.com,ikarem.io,meraki.com,network-auth.com
The Coca-Cola Company Vulnerability Disclosure Program|appletiser.com,barqs.com,blueskysoda.com,coca-cola-deutschland.de,coca-cola-france.fr,coca-cola-oesterreich.at,coca-cola.com,coca-colaarabia.com,coca-colacompany.com,coca-colaentuhogar.com,coca-colaitalia.it,coca-colamaroc.ma,coca-colaukraine.com,cocacola-kos.com,cocacolabelgium.be,cocacolaespana.es,cocacolanederland.nl,cocacolaportugal.pt,cocacolastore.fr,cokestore.com,cokeurl.com,dasani.com,dietcoke.com,drinkaha.com,drinkmoxie.com,fresca.com,fuzebev.com,hansens.com,hi-c.com,honesttea.com,ko.com,melloyello.com,pibb-xtra.com,powerade.com,sprite.com,surge.com,testko.com,topochico.com,vebatcoke.com,vitaminwater.com
Comcast Xfinity Bug Bounty|comcast.com
Comcast Xfinity Vulnerability Disclosure Program|comcast.com,sys.comcast.net,xfinity.com
CyberGhost|cyberghost.com,cyberghostvpn.com
Department of Homeland Security: Vulnerability Disclosure Program|BIOMETRICS.GOV,CBP.GOV,CISA.GOV,CPNIREPORTING.GOV,CYBER.GOV,CYBERSECURITY.GOV,DISASTERASSISTANCE.GOV,DOTGOV.GOV,E-VERIFY.GOV,EVERIFY.GOV,EVUS.GOV,FEMA.GOV,FIRSTRESPONDERTRAINING.GOV,FLETA.GOV,FLETC.GOV,FLOODSMART.GOV,GET.GOV,GLOBALENTRY.GOV,HOMELANDSECURITY.GOV,ICE.GOV,JUNTOS.GOV,LISTO.GOV,NIC.GOV,NIEM.GOV,NMSC.GOV,POWER2PREVENT.GOV,PREVENTIONRESOURCEFINDER.GOV,READY.GOV,READYBUSINESS.GOV,SAFETYACT.GOV,SCHOOLSAFETY.GOV,SECRETSERVICE.GOV,STOPRANSOMWARE.GOV,TOGETHER.GOV,TSA.GOV,US-CERT.GOV,USCG.GOV,USCIS.GOV,USSS.GOV
DICK'S Sporting Goods|calia.com,dcsg.com,dickssportinggoods.com,fieldandstreamshop.com,goinggoinggone.com,golfgalaxy.com,publiclands.com,vrst.com
Directly|directly.com,sandbox.directly.com
Dropbox|docsend.com,dropboxforum.com,hellofax.com,hellosign.com,helloworks.com
Ecommpay Vulnerability Disclosure Program|ecommpay.com
US Environmental Protection Agency Vulnerability Disclosure|FEDCENTER.GOV,FRTR.GOV,GLNPO.GOV,SUSTAINABILITY.GOV,URBANWATERS.GOV
ExpressVPN|expressobutiolem.onion,expressvpn.com,xvservice.net,xvtest.net
Flourish|flourish.studio,xyzbmojn.net
Gap Inc.|gapinc.com
Geotab: VDP|bsmtechnologies.com,bsmwireless.com,geotab.ca,geotabinc.com,intendia.com,lat-lon.com,mobicorp.com,neutralvehicle.com,webtechwireless.com
HealthifyMe's Vulnerability Disclosure Program|healthifyme.com
HubSpot|growth.org,hs-sites.com,hubapi.com,hubspot.com,hubspot.net,hubspotemail.net
Hummingbird VDP|hummingbird.co
iFood: Bug Bounty Program|movilepay.com,movilepay.com.br
Jora|jora.com,jora.xyz
Just Eat - Managed Bug Bounty|just-data.io,just-eat.io,justeat-int.com
Kaleido|designify.com,kaleido.ai,remove.bg,unscreen.com
Latitude Financial Services Vulnerability Disclosure Program|28degreescard.com.au,buyersedge.com.au,carecredit.com.au,gemcreditline.co.nz,gemfinance.co.nz,gemvisa.com.au,genoapay.co.nz,genoapay.com,gomastercard.com.au,interestfree.com.au,latitudefinancial.co.nz,latitudefinancial.com,latitudefinancial.com.au,latitudeinfinity.com.au,latitudepay.com,latitudepay.com.au,umiloans.com.au
Lenovo Responsible Disclosure|lenovo.com,lenovo.com.cn,motorola.com,motorola.com.br,motorola.com.cn
Lime|li.me,lime.bike,limeinternal.com
Linktree|album.link,artist.link,linktr.ee,linktree-extensions.com,linktree.com,mylink.page,odesli.co,odesli.com,playlist.link,pods.link,song.link,songlink.io,tr.ee
lululemon|lululemon.co.uk,lululemon.com
Mettle|bbp-mettle.co.uk
Monash University Vulnerability Disclosure Program|erc.monash.edu,monash.edu
NameJet VDP|namejet.com
Naspers|naspers.co,naspers.co.in,naspers.com,naspers.fr,naspers.us,naspersventures.com,prosus.com
NAB's Responsible Disclosure Program|advantedge.com.au,claiming.com.au,globalfintechlink.com,hicaps.com.au,jbwere.co.nz,jbwere.com.au,lanternpay.com,medfin.com.au,nab.com.au,nabbroker.com.au,nabmarginlending.com.au,nabtrade.com.au,ubank.com.au
The NatWest Group Vulnerability Disclosure Program|coutts.com,natwest.co.uk,natwest.com,natwestgroup.com,rbs.co.uk,rbs.com,ulsterbank.co.uk,ulsterbank.com,ulsterbank.ie
Netflix|netflix.com,nflxext.com,nflximg.net,nflxso.net,nflxvideo.net,prod.cloud.netflix.com,prod.dradis.netflix.com,prod.ftl.netflix.com
BlueHost VDP|bluehost.com,bluehost.in
Newfold Builder VDP|websitebuilder.com
Newfold Hostgator India VDP|hostgator.in
Reseller Club VDP Pro|resellerclub.com
Octopus|octopus.com
OLX EU|imovirtual.com,olx.pl,olx.pt,otodom.pl,otomoto.pl,standvirtual.com
OLX Autos|321sprzedane.pl,letgo.com,olx-autos.com.ar,olx.id,olx.in,olxautos.cl,olxautos.co.id,olxautos.com.co,olxautos.com.mx,olxautos.in,otoplus.com
OpenAI|openai.com,openai.org
Opera Public Bug Bounty|apex-football.com,dailyadvent.com,feednews.com,oleads.com,opera-mini.net,opera.com,opera.news,opera.software,opera.technology,operafootball.com,operanewsapp.com,osp.opera.software,sec-tunnel.com,yoyogames.com
Opsgenie|opsgenie.com
Origin Energy|api.originenergy.com.au,download.originenergy.com.au,odcdn.com.au,origindigital-pac.com.au,originenergy.com.au,support.originenergy.com.au
Overstock's Vulnerability Disclosure Page!|handmade.com,overstock.com,supplieroasis.com
Pexels|pexels.com
Pixabay|pixabay.com
Private Internet Access|privateinternetaccess.com
Rakuten VDP|rakuten.com
Rapyd|korta.is,kortathjonustan.is,neat.com.hk,neat.hk,neat.wtf,neatcommerce.com,neattest.com,rapyd.com,rapyd.net,rapyd.org
Regions Bank Vulnerability Disclosure Program|clearsightadvisors.com,enerbank.com,regions.com,regions.us,regions6x.com,regionsapps.com,regionsdev.com,regionsmortgage.com,regionsqa.com,regionsretirement.com,regionssource.com,rgbk.com,sabal.com
RMIT University Vulnerability Disclosure Program|rmit.edu.au,rmit.edu.vn
Roobet Vulnerability Disclosure Program|roobet.com
Seagate VDP|seagate.com
SEEK|aips-internal.com,aips-services.com,certsy.com,certsynonprod.com,jobapi.io,jobapi.net,myseek.xyz,outfra.xyz,seek.com,seek.com.au,skinfra.xyz,sol-data.com
1Shoppingcart.com|mcssl.com
Skyscanner|skyscanner.net
Smartmockups|smartmockups.com
SnapNames VDP|snapnames.com
Sophos|astaro.at,astaro.ch,astaro.com,astaro.de,astaro.info,astaro.net,astaro.org,cyberoam.com,fw-notify.net,hitmanpro.com,hitmanpro.nl,mojave.net,myastaro.com,reflexion.net,sophos.com,surfright.nl
SoundCloud|repostnetwork.com,s-cloud.net,services.repostnetwork.com,soundcloud.com,soundcloud.org,soundcloudmail.com
Square|square.com,squareup.com
Statuspage|statuspage.io
Takeaway.com|10bis.co.il,bistro.sk,citymeal.com,eat.ch,just-eat.dk,just-eat.fr,just-eat.no,justeattakeaway.com,lieferando.at,lieferando.de,pyszne.pl,scoober.com,takeaway.com,takeawayriders.com,thuisbezorgd.nl,yourdelivery.de
Telef√≥nica Germany|aetkasmart.de,alditalk-kundenbetreuung.de,ayyildiz.de,base.de,blau.de,blauworld.de,einfachprepaid.de,epos.vertriebspartner.de.o2.com,fonic-mobile.de,fonic.de,mediamarkt.o2service.de,mein.aetkasmart.de,mein.simfinity.de,nettokom.de,netzclub.net,norma-mobil.de,nova-mobil.de,nova-mobile.de,o2.com,o2.de,o2business.de,o2online.de,o2service.de,o2spin.de,ortelmobile.de,saturn.o2service.de,sim-karte-aktivierung.blauworld.de,simfinity.de,telefonica.de,turkei-sim.de,whatsappsim.de
Tesla|solarcity.com,tesla.cn,tesla.com,tesla.services,teslainsuranceservices.com,teslamotors.com
Trello|butlerfortrello.com,trello.com,trello.services
TripAdvisor|bokundemo.com,bokuntest.com,flipkey.com,holidaylettings.com,housetrip.com,niumba.com,vacationhomerentals.com
Under Armour AppSec|api.ua.com,endomondo.com,mapmyfitness.com,mapmyride.com,mapmyrun.com,mapmywalk.com,myfitnesspal.com,ua.com,underarmour.co.uk,underarmour.com
Unilever Vulnerability Disclosure Program|Algida.pl,Uol-maint.unilever.com,VO5.co.uk,YoungEntrepreneursAwards.Unilever.com,axe.com,bedhead.comuk,br.recepedia.com,clearhaircare.comsg,close-up.com,conimex.nl,degreedeodorant.com,domestos.complhome.html,elidor.com.tr,folicure.com.mx,getsetclean.ininhi,glowandlovelycareers.inen,hellmanns.comuk,ingman.fi,joko.co.zaen,jornadababydove.com.br,kbright.com.sg,klondikebar.com,knorr.com,kwalitywalls.inhome.html,lifebuoy.com,lipton.com,lovehomeandplanet.com,missionsignal.fr,mx.recepedia.com,neutral.lv,pepsodent.com,promocjeunilever.pl,pureitwater.comIN,rin.in,skinsei.com,stives.com,suave.comusen,sunsilk.co.id,tiendavirtual.mutual-all.com.ar,toolkithomecare.com,tresemme.com,unilever.com,unilever.com.br,unilever.gr,unilever.ro,unileverhealth.co.za,uniquelyunilever.com,unox.nl,urbanmonkey.sk,uttcentraldb.com,vazoplintirio.gr,veksthus.knorr.no,vivaelagua.com.mx,voteuntukimpianku.com,wa-na.unileversolutions.com,wakacjezknorr.pl,wallsthailand.com,weareul.com,whatsfordinner.co.za,whitenow.com,yukmulaibijakplastik.com,yulaenergy.com,zest.com.mx,zmrzlina-misa.sk
United Airlines|ual.com,united.com
United States Agency for Global Media Vulnerability Disclosure Program|alhurra.com,insidevoa.com,opentech.fund,radiosawa.com,radiotelevisionmarti.com,rfa.org,rferl.org
Verisign|domainscope.com,namestudio.com,namestudioforsocial.com,youcouldbe.com
Viator|viator.com,viatorinc.com
Web.com VDP|networksolutions.com,register.com,web.com
Wise (ex-TransferWise)|transferwise.com,wise.com
Xfinity Home & xFi|xfinityhome.com,xfiplatform.com
KKR-VDP|kkr.cloud,kkr.com
Intuit|intuit.com,mailchimp.com,mint.com,quickbooks.com,turbotax.com
Mount Sinai Health|arnholdinstitute.org,bethisraelny.org,carelink.mountsinaiconnect.org,cccsymposium.org,dubinbreastcenter.com,healthandhealingny.com,healthandhealingny.org,healthbytesnyc.com,medicalconciergenyc.com,mountsinai.org,mountsinaiconnect.org,mountsinaidoctors.org,mountsinaiheartnp.org,msonsitehealth.org,mssm.edu,nycepilepsyteam.com,nyee2020.com,nyeesurgnet.com,sarcoidosis.org,sinaidowntown.net,slrortho.com,snch.org,southnassau.org,stlukeshospitalnyc.org,stoppain.org,thechep.org,thehealthcenterhudsonyards.com,usmgny.org,wtcexams.org
Fidelity|fidelity.com
Payoneer|payoneer.com
Veeam|kasten.io,veeam.com,veeamgov.com
M&T Bank Vulnerability Disclosure|leafnow.com,mtb.com,trustnota.com,wilmingtontrust.com
BlackRock|blackrock.com,ishares.com
Stripe|getbouncer.com,indiehackers.com,link.co,payable.com,recko.io,reckoproduction.com,reckostaging.com,stripe.com,touchtechpayments.com
Paystack Vulnerability Disclosure|paystackintegrations.com
Citrix Systems|browser.cloud.com,citrixworkspacesapi.net
TikTok|tiktok.com,tiktokv.com
PlayStation|api.playstation.com,playstation.com,playstation.net,sonyentertainmentnetwork.com
Wells Fargo|advisor-connection.com,mworld.com,wellsfargo.com,wellsfargoadvisors.com,wf.com,wystar.com
KeyBank|bolstr.com,cainbrothers.com,hellowallet.com,key.com,keybank.com,laurelroad.com
Equifax-vdp|accountscore.co.uk,accountscore.com,accountscore.net,ansoniacreditdata.com,datacredito.com,datacredito.com.do,datacredito.info,datacredito1.com,datacredito2.com,datacredito3.com,dicom.cl,efficientforms.com,efficienthire.com,employersedge.com,employersedge.net,equifax.cl,equifax.com,equifax.com.pe,healthefx.net,healthefx.us,healthefxforms.us,hiretech.com,i2verify.com,i9advantage.com,i9anywhere.com,kount.com,kount.net,mapcity.com,midigator.com,talx.com,wageverify.com
Capital One|bluetarp.com,capitalone.ca,capitalone.co.uk,capitalone.com,capitalone.tz,capitalone360.com,capitalonebank.com,capitalonecards.com,capitalonecareers.co.uk,capitaloneshopping.com,criticalstack.com,konylabs.capitalone,luma.co.uk,mobile.prod,paribus.co,teamstercardnow.com,theunioncard.com,ukcapitalone.capitalone,unitedincome.com,usejewel.com,wikibuy.com
Merck & Co., Inc., Rahway, NJ, USA|merck.com,msd.com
Ford|ford.com,lincoln.com,motorcraft.com,omnicraftautoparts.com,quicklane.com
PayPal|braintree-api.com,braintree.tools,braintreegateway.com,braintreepayments.com,hyperwallet.com,loanbuilder.com,paydiant.com,paylution.com,paypal.com,paypal.here,paypal.me,paypalcorp.com,paypalobjects.com,py.pl,swiftcapital.com,swiftfinancial.com,venmo.com,xoom.app,xoom.com
Goldman Sachs|advisorsolutions.gs.com,ayco.com,claritymoney.com,finlife.com,finlifepartners.com,folioclient.com,foliodigitalwealth.com,foliofirst.com,foliofn.com,folioidentity.com,folioinstitutional.com,folioinvesting.com,genesiscapital.com,global-liquidity.gs.com,goldman.com,goldmanpfm.com,goldmansachs.com,goldmansachsindices.com,gs-mosaic.gs.com,gs-mosaic.qa.gs.com,gs.com,gs.de,gsam.com,gspublishing.com,gsselect.com,honestdollar.com,marcus.co.uk,marcus.com,nnip.com,qaglobal-liquidity.gs.com,rocaton.com,unitedcp.com,vennhypotheken.nl
Epic Games|3lateral.com,amplitude-game.com,artstation.com,audicagame.com,bandcamp.com,bcbits.com,cubicmotion.com,dancecentral.com,dropmix.com,easy.ac,epicgames.com,epicgames.dev,fallguys.com,fortnite.com,harmonixmusic.com,hmxservices.com,hmxwebservices.com,jellychat.com,mediatonic.co.uk,oncatapult.com,popjam.com,psynet.gg,psyonix.com,quixel.com,rockbandvr.com,rocketleague.com,rukkaz.com,singspacegame.com,sketchfab.com,superawesome.com,superawesome.tv,superbeatsports.com,unrealengine.com,unrealtournament.com
Deliveroo|deliveroo-data-test.io,deliveroo-data.io,deliveroo-data.net,deliveroo-streams.net
Rockstar Games|lifeinvader.com,rockstargames.com,rockstarnorth.com
GitHub|github.com,github.net,githubapp.com,githubassets.com,githubusercontent.com,githubwebhooks.net,lgtm.com,semmle.com,semmle.net
Robinhood|rhinternal.net,robinhood.com,robinhood.net
Airbnb|airbnb-aws.com,airbnb.app,airbnb.com,airbnbcitizen.com,atairbnb.com,byairbnb.com,hoteltonight-test.com,luckey.app,luckey.fr,luckey.in,luckey.partners,luckeyhomes.com,luxuryretreats.com,muscache.com,urbandoor.com,withairbnb.com
Adobe|acrobat.com,adobe.com,adobe.io,adobeaemcloud.com,adobeconnect.com,adobecqms.net,bizible.com,marketo.com,mixamo.com,omniture.com,omtrdc.net,phonegap.com,proofhq.com,scene7.com,testdrive.workfront.com,tt.omtrdc.net,tubemogul.com,typekit.com,workfront.com
Snapchat|bitmoji.com,bitstrips.com,sc-core.net,sc-corp.net,scan.me,snapchat.com,spectacles.com
Uber|uber.com,uberinternal.com
Cloudflare Public Bug Bounty|cloudflare.com,cloudflareaccess.com,cloudflarepartners.com,cloudflareworkers.com,teams.cloudflare.com
Coinbase|base.org,cbhq.net,coinbase.com,coinbase.pro,paradex.io
Slack|quip.com,slack.com,slackb.com
HackerOne|hacker101.com,hackerone-ext-content.com,hackerone-user-content.com,hackerone.com,hackerone.net,vpn.hackerone.net
Magic Eden|coralcube.io,magiceden.dev,magiceden.io,magiceden.workers.dev
Algemeen Dagblad|ad.nl
Azena|azena.com
BCC|bcc.nl
BMC|bmc.nl
CM.com|ticketing.cm.com,cm.com
Canada Post + Purolator - Responsible Disclosure Program|canadapost-postescanada.ca,postescanada-canadapost.ca,purolator.com
DPG Media|dpgmedia.be,dpgmedia.nl
DataCamp|datacamp.com
De Morgen|demorgen.be
De Volkskrant|volkskrant.nl
Digitaal Vlaanderen|vlaanderen.be
EURid|das.eu,dns.eu,eurid.eu,nic.eu,registry.eu,whois.eu,yadifa.eu
GULP|gulp.ch,gulp.de
Hardware Info|hwigroup.com
Here Technologies|account.api.here.com,account.here.com,mobilitygraph.hereapi.com,router.hereapi.com,scbe.api.here.com,subp-router.hereapi.com,here.com,hereapi.com
Het Laatste Nieuws|hln.be
Het Parool|parool.nl
Humo|humo.be
Infomaniak|kchat.infomaniak.com,drive.infomaniak.com,infomaniak.site
InnoGames|igpayment.com,innogames.de,innogames.com
Intel¬Æ|intel.com
Intergamma|intergamma-test.nl,intergamma.cloud,restintergamma.nl,werkenbijgamma.be,werkenbijgamma.nl,werkenbijkarwei.nl,karweioutletstore.nl
Jooki|jooki.rocks,muuselabs.com
Kinepolis Group|klubcinema.fr,kinepolis.be,kinepolis.ch,kinepolis.com,kinepolis.fr,kinepolis.lu,kinepolis.nl,landmarkcinemas.com,mjrtheatres.com
Lansweeper|lansweeper.com
Libelle|libelle.nl
Mobile Vikings|mas.mobilevikings.be,mobilevikings.be,prd-pub.mobilevikings.be,prd.mobilevikings.be,acc-pub.mobilevikings.be,acc.mobilevikings.be,dev-pub.mobilevikings.be,dev.mobilevikings.be
Monster Worldwide|military.com,monster.at,monster.be,monster.ca,monster.ch,monster.co.uk,monster.com,monster.de,monster.dk,monster.es,monster.eu,monster.fr,monster.hu,monster.ie,monster.it,monster.lu,monster.no,monster.pt,monster.se,monsterboard.nl,monsterpolska.pl
Moralis VDP|bigmoralis.com,grandmoralis.com,moralisapp.com,moralishost.com,moralisweb3.com,usemoralis.com
Napoleon Games NV|napoleongames.be
Nestl√© VDP|nestle.com
Ninja Kiwi Games|nkstatic.com,ninjakiwi.com,souparea.com
Personio|personio-internal.de,personio.tools
Port of Antwerp-Bruges|c-point.be,portofantwerp.com,portofantwerpbruges.com
SBB - Swiss Federal Railways|sbb.ch,swisspass.ch
Sentiance|sentiance.com
Sixt|sixt.com,sixt.de
Speakap Responsible Disclosure|speakap.com,speakap.io
Sqills|sqills.team,sqills.com
Tomorrowland|aroundtheworld.tomorrowland.com,tomorrowland.com
Trouw|trouw.nl
TrueLayer|truelayer.cloud,truelayer.com,truelayer.io
Twago|itprojects.talent-community.com
Tweakers|tweakblogs.net,tweakers.net,tweakimg.net
UZ Leuven|kwsdose.be,playuzleuven.be,mir.uzleuven.be
Uphold.com|uphold.com
VRT responsible disclosure|canvas.be,dewarmsteweek.be,ketnet.be,klara.be,mnm.be,radio1.be,radio2.be,radioplus.be,sporza.be,stubru.be,vrt.be
VTM GO|vtm.be,vtmgo.be
Vlerick Business School|vlerick.com
WP Engine|deliciousbrains.com,studiopress.com,wpengine.io,wpesvc.net
Yacht|yacht.nl
iBOOD.com|forum.ibood.com,ibood.io,ibood.com
intigriti|intigriti.com,intigriti.me
ATG Public Bug Bounty Program|atg.se
Alasco GmbH - Bug Bounty Program|alasco.de,alasco.rocks
Contentsquare Bug Bounty Program|contentsquare.com
Dailymotion public bug bounty|api.dailymotion.com,dailymotion.com,dailymotionadvertising.com,dm.gg,dmcdn.net,dmxleo.com
Lazada|lazada-seller.cn,lazada.co.id,lazada.co.th,lazada.com,lazada.com.my,lazada.com.ph,lazada.sg,lazada.vn,lazlogistics.co.id,lazlogistics.in.th,lazlogistics.my,lazlogistics.ph,lazlogistics.sg,lazlogistics.vn,lel.asia,lel.global,lex.co.id,lex.com.my,lex.in.th,lex.ph,lex.vn,pickmee.id,pickmee.in.th,pickmee.my,pickmee.ph,pickmee.sg,pickmee.vn,redmart.com,supertms.com
Muslim Pro|muslimpro.com
OVO Bug Bounty Program|ovo.id,taralite.com
Telenor Sweden Public Bug Bounty Program|bredbandsbolaget.se,europolitan.se,ownit.se,telenor.se
4chan|4chan.org,4cdn.org
84codes|cloudamqp.com,cloudkarafka.com,elephantsql.com,cloudmqtt.com
8x8|8x8.com,dxi.eu,callstats.io,jit.si,wavecell.com,ucverse.com,mycontactual.com,jitsi.org,packet8.net,get8x8.com,8x8.vc,easycontactnow.com,8x8.spot,sameroom.io
AAX|aax.com
Abercrombie & Fitch Management Co.|abercrombie.com,hollisterco.com
Achmea|achmea.nl,syntrus.com,woonfonds.nl,fbto.nl,averoachmea.nl,union.sk,centraalbeheer.nl,defriesland.nl,eurocross.com,interpolis.nl,prolife.nl,zilverenkruis.nl,achmea.com.au,eurekosigorta.com.tr,interamerican.gr,actify.nl,onlia.ca
Acronis|acronis.com,5nine.com,devicelock.com,acronis.work
Adafruit|adafruit.com,adafruitdaily.com
Agicap|agicap.com
AIMS360|aims360.com
AirMap|airmap.com
Airship|airship.com,airship.eu,apptimize.eu,apptimize.com,accengage.net,urbanairship.com
Airtable|airtable.com,staging-airtableblocks.com
Aiven|aiven.io
Alasco GmbH|alasco.de,alasco.rocks
Alaska Airlines|alaskaair.com
Algolia|algolianet.com,algolia.com,algolia.net
Alibaba|cainiao.com,cainiao-inc.com,alibaba.com,aliexpress.com,taobao.com,tmall.com,aliyun.com,alibabacloud.com,1688.com,dingtalk.com,alibaba-inc.com,aliyun-inc.com,alimama.com,ele.me,koubei.com,alipay.com,kaola.com,etao.com,alibabagroup.com,amap.com,gaode.com,youku.com,aliyuncs.com
Allbridge|allbridge.io
Allegion|allegion.com,specadsystems.com,isonas.com,krytonitelock.com,republicdoor.com,schlage.com,fireglass.com,yonomi.co,trelock.com,simons-voss.com,milre.com,interflex.de,gainsboroughhardware.com.au,fshlocking.com.au,allegion.co.uk,cisa.com,brio.com.au,brionz.com,briouk.com,briousa.com,bricard.com,axasecurity.com,ausloc.com,allegionengage.com,isonaspureaccesscloud.com,my-mobilekey.com,yonomi.com,nombau.de
Allegro|allegrosandbox.pl
Alohi|fax.plus,sign.plus,alohi.com
Amazon|amazon.com,amazon.co.uk,amazon.co.jp,amazon.de,amazon.fr,amazon.com.br,amazon.ca,amazon.com.mx,amazon.cn,amazon.in,amazon.sg,amazon.com.tr,amazon.ae,amazon.it,amazon.nl,amazon.es,amazon.se,amazon.com.au
AMERICAN SYSTEMS|alexamerican.com,alexamericansystems.com,americansystems.com,ascvpc.com,ascsites.com,ascgov.com,ddlomni.com,nhaero.com,americansystems.info,amsyscorp.com,2asc.com,americanalliant.com,asc.name,digitalaccess.com,americansystemsuniversity.com,americansystems.org,thoughtmill.com,american-systems.org,american-systems.com,asextranet.com,emsolutionsinc.com,emsolve.com,essworld.net,nswccd-fbw-scs.com,asvpc.com,alex-as.com
Amitree Inc|amitree.com
AmoCRM|amocrm.com,amocrm.ru
Amon|amon.tech
Amsterdam Airport Schiphol|schiphol.nl,schiphol.com
Apple|apple.com,icloud.com
Apsis|apsis.com
Arlo Cash Rewards|arlo.com
Arrival|arrival.com,arrival.co
AT&T|att.com
Australia Post|auspost.com.au
Automata Network|ata.network,1rpc.io,2fa.guru,nftfair.app,anydao.app,xata.fi
Automattic|intensedebate.com,simplenote.com,happy.tools,simperium.com,akismet.com,mailpoet.com
Auvik|auvik.com
Avail Carsharing|availcarsharing.com
Avalanche|avalabs.org,avax.network,avax-test.network,avax-dev.network
Avalara VDP|avalara.com,avalara.net,avalara.io,papercrane.io,inposia.com,netleglobal.com,crowdreason.com,track1099.com,3ce.com,davosalestax.com,ttrus.com,impendulo.com
AVROTROS|avrotros.nl
Backblaze|backblazeb2.com,backblaze.com
Badoo|badoo.com,badoocdn.com,hotornot.com
Baidu|baidu.com,hao123.com
BBC|bbc.com
Bentley|bentley.com
Bigbank|bigbank.at,bigbank.de,bigbank.ee,bigbank.eu,bigbank.fi,bigbank.lt,bigbank.lv,bigbank.nl,bigbank.se
BigONE Global Exchange|big.one,bigone.com
Bime|bime.io,bimeanalytics.com
Binary|binary.com
BingX Exchange|bingx.com,bingx.pro
Bit.com|bit.com
Bitaccess|bitaccessbtm.com,faa.st
Bitfinex|bitfinex.com
BitForex|bitforex.com
BitGo|bitgo.com
Bitkub|bitkub.com
BitMart Exchange|bitmart.com
BitMEX|bitmex.com
Bitrue|bitrue.com
Bitwarden|bitwarden.com
BKEX|bkk.fun,bkex.com
BlaBlaCar|blablacar.fr,blablacar.de,blablacar.co.uk,blablacar.in,blablacar.es,blablacar.mx,blablacar.be,blablacar.hr,blablacar.hu,blablacar.it,blablacar.nl,blablacar.pl,blablacar.com.br,blablacar.pt,blablacar.ro,blablacar.ru,blablacar.com,blablacar.com.tr,blablacar.com.ua,blablalines.com,blablacardaily.com
Blend Labs|blendlabs.com,blend.com
Blockchain|blockchain.com,blockchain.info
Blue Jeans Network|bluejeans.com
Bluesnap|bluesnap.com
BMW Group|bmw.de,mini.de,bmw-motorrad.de
Boozt Fashion|boozt.com,booztlet.com
Brave Software|basicattentiontoken.org,brave.com
BtcTurk|btcturk.com
BTSE|btse.com
Buffer|buffer.com
Bugcrowd|bugcrowd.com
BugPoC|bugpoc.com,bugpoc.ninja
Bugv|bugv.io
Bullish|bullish.com
Bunq VDP|bunq.com
Canon|canon.com
Casper|casper.com,casper.tools
CBRE|cbre.com,trammellcrow.com
CBS|cbs.nl
Cedars-Sinai|cedars-sinai.org,cshs.org,csmc.edu,mycslink.org,marinahospital.com,cedars-sinai.edu,kerlanjobe.org
Central Security Project|maven.org
Centrify|centrify.com
CFP Time|cfptime.org
Chainlink|chain.link,smartcontract.com
Chargezoom|payportal.net
Chase|chase.com,jpmorganchase.com
Chaturbate|chaturbate.com,securegatewayaccess.com,highwebmedia.com
Check Point|checkpoint.com
Circle|circle.com
Cirrus Insight|cirrusinsight.com,cirruspath.com,zynbitdev.com
City of Los Angeles VDP|lacity.org,lacity.gov
cLabs|celo.org
Clario|clario.co,mackeeper.com
Clause|clausestaging.com
Clickup|clickup.com
Clio|clio.com
Cloudinary|cloudinary.com
Cloudways|cloudways.com
Coalition|thecoalition.com
Cobinhood|cobinhood.exchange,cobinhood.com
Coda|coda.io
CodeChef|codechef.com
Codefi|codefi.network
CodeIgniter|codeigniter.com
Coin98|coin98.com
Coindcx|coindcx.com,dcxstage.com,dcxlearn.com
CoinGecko|coingecko.com,geckoterminal.com
CoinMetro|coinmetro.com
Coinsbit|coinsbit.io
Coinspot|coinspot.com.au
Coinstore|coinstore.com
CompanyHub|companyhub.com
Conclusion|conclusion.nl
Connectis|connectis.com
Consensys|consensys.net,nfura.io
Constant Contact|constantcontact.com,singleplatform.com
Consumer Financial|consumerfinance.gov
Consumersenergy VDP|cmsenergy.com,consumersenergy.com,applianceserviceplan.com,cms-enterprises.com
Core|core.app
Cornershop|cornershopapp.com,superpal.com,cornershop.io,superpal.io
Costco|costco.com,costco.ca,costcobusinessdelivery.com,costcobusinesscentre.ca
Courier|trycourier.app,trycourier.com,ct0.app
Coursera|coursera.org
Credit Karma|creditkarma.com,creditkarma.ca
Crowdin|crowdin.com
Crowdstrike|crowdstrike.com,crowdstrike.org,falcon-sandbox.com,hybrid-analysis.com,reverse.it
Crypto.com|mona.co,monaco.mobile,crypto.com
Cryptology|cryptology.com
Curve|imaginecurve.com,curve.app,curve.com
Cuvva|cuvva.co,cuvva.com,cuv-prod.app
CVS Health VDP|cvs.com,cvshealth.com
Cynical Technology|cynicaltechnology.com,cynicaltechnology.com.np,cynical.com.np
D66|d66.nl
Danskebank|danskebank.com,danskebank.dk,june.dk,sunday.dk
Dashlane|dashlane.com
Data Processing (IBB)|sf.net,libav.org,videolan.org
Databricks|databricks.com,spark-summit.org,delta.io,spark-portal.org,spark-summit.com
DATADOME|datadome.co
DataStax|datastax.com
Datto VDP|autotask.net,backupify.com,bitdam.com,centrastage.net,cloudtrax.com,datto.com,dattobackup.com,gluh.co,openmesh.com,infocyte.com,soonr.com
De Rechtspraak|rechtspraak.nl
De Volksbank|devolksbank.nl,asnbank.nl,blgwonen.nl,regiobank.nl
Deezer|deezer.com
Delight.im|briefe.io,delight.im,moviecontentfilter.com
Dell Technologies|dell.com,dellemc.com,delltechnologies.com,emc.com,rsa.com,rsaconference.com,secureworks.com
Deribit|deribit.com
Deutsche Bank|db.com
Deutsche Telekom|telekom.de,telekom.net,telekom.com,t-systems.com
Dex-Trade|dex-trade.com
Didi|didichuxing.com,xiaojukeji.com,didiglobal.com,udache.com,didiyun.com
DIFX|difx.com
DigitalOcean|digitaloceanspaces.com,digitalocean.com
Discord|discord.com
DJI|dji.com,skypixel.com,djicdn.com,djivideos.com,dji.net,robomaster.com,djiservice.org
Doctolib|doctolib.fr,doctolib.de,doctolib.it,doctolib.com,doctolib.net
Doist|todoist.com,twist.com
Dokobit|dokobit.com
DPG Media|dpgmedia.be,dpgmedia.nl
DropBox|dropbox.com,hellosign.com,helloworks.com,dropboxforum.com
DuckDuckGo|duckduckgo.com
Dutch Tax Office|belastingdienst.nl
Easyname|easyname.com
Easyprojects|easyprojects.net
EC-Council|eccouncil.org
Ecobee|ecobee.com
Ed|bugbountyguide.com,cryptojourney.com,edoverflow.com,securitytxt.org,wewriteyour.report
Eerste Kamer|eerstekamer.nl
EFF|eff.org
Elastic|elastic.co,found.io,swiftype.com,elstc.co,elasticnet.co,eops.nl,elastic-cloud.com
Elementor|elementor.com
ELO|elo.com.br
Empuls|empuls.io
Endless Hosting|endlcdn.site,theendlessweb.com,djelectro.me
Engel & V√∂lkers|engelvoelkers.com
Eobot|eobot.com
EPAM|epam.com
ESLint|eslint.org
eToro|etoro.com,etoropartners.com,delta.app
Etsy|etsy.com,etsypayments.com
European Central Bank|europa.eu
Eventbrite|eventbrite.com,eventbrite.nl
Evernote|evernote.com
Every|every.org
EXMO|exmo.com,exmo.me
Exodus|exodus.io,exodus.com
Expedia Group|expedia.com,hotwire.com,orbitz.com,hotels.com,homeaway.com,cheaptickets.com,travelocity.com,wotif.com,cruiseshipcenters.com,lastminute.com.au,carrentals.com,expediapartnercentral.com,abritel.fr,bookabach.co.nz,fewo-direkt.de,stayz.com.au,expediagroup.com,egadvertising.com,flights.com,hoteles.com,hoteis.com,vrbo.com,hotwirepartnercentral.com,ebookers.com,mrjet.se,expediapartnersolutions.com,ean.com,lastminute.co.nz,travelocity.ca,expediaagents.com
Facebook|facebook.com,fb.com,fb.me,messenger.com,thefacebook.com,accountkit.com,instagram.com,freebasics.com,internet.org,oculus.com,whatsapp.com,meta.com,mapillary.com,whatsapp.net
FanDuel|fdbox.net,fanduel.com,fanduel.design
Fastly VDP|signalsciences.com,fanout.io
Fetlife|fetlife.com
fidentity|fidentity.ch
Fig|fig.co
Files.com|files.com
FileZilla|filezilla-project.org
FINRA Response|finra.org
FireEye|fireeye.com
FIRST|first.org
Fitbit|fitbit.com,fitstar.com
Flexport VDP|flexport.com,transmissionapp.com
Flickr|flickr.com
Flipkart|flipkart.com
FloQast|floqast.app
Fondy|fondy.eu,fondy.io,fondy.ua,fondy.ru,cloudipsp.com,cipsp.net
ForeScout Technologies|forescoutcloud.net,forescout.com
FoxyCart|foxycart.com
Freshworks|freshworks.com,freshdesk.com,freshservice.com,freshsales.io,freshcaller.com,freshchat.com,freshmarketer.com,freshconnect.io,freshping.io
Gate.io|gate.io
Genasys Technologies|genasys.tech
Gener8|gener8ads.com
Geotab|geotab.com
GitLab|gitter.im,gitlab.com
Glassdoor|glassdoor.app,glassdoor.com
Gmelius|gmelius.com
GObugfree|gobugfree.com
GOJEK|gojekapi.com,gopayapi.com,findaya.com,findaya.co.id,mab.co.id,gojek.co.id
GoodRx|goodrx.com
Google|google.com,youtube.com,projectbaseline.com,onduo.com,verily.com,blogger.com,signalpath.com
Government of Netherlands|0800-8051.nl,0900-8844.nl,09008844.nl,112test.nl,1813-2013.nl,1meter35.nl,1ratio.nl,2013russiaholland.nl,247bz.nl,380kv-hoogspanningsverbinding.nl,380kv-hoogspanningsverbindingen.nl,380kv-verbinding.nl,380kv-verbindingen.nl,380kv.nl,8000488.nl,8007000.nl,8008051.nl,9008844.nl,a16rotterdam.nl,a1oost.nl,a27a12ringutrecht.nl,a27houtenhooipolder.nl,a28a1knooppunthoevelaken.nl,a4burgerveen-n14.nl,a4haaglanden-n14.nl,a58tilburgbreda.nl,a6zonlelystaddronten.nl,a7a8.nl,aanbiedersmedicijnen.nl,aandachtvoorelkaar.nl,aandeslagmetdenatuurwet.nl,aandeslagmetdeomgevingswet.nl,aangifteservice.nl,aaninhetdonker.nl,aanmelder.nl,aanpakjeugdwerkloosheid.nl,aanpaklerarentekort.nl,aanpakringzuid.nl,aanpakstikstof.nl,aardgasvrijewijken.nl,abdleerportaal.nl,academieinternationalebetrekkingen.nl,academievoorhrm.nl,academievoorinternationalebetrekkingen.nl,academyforinternationalrelations.nl,academyinternationalrelations.nl,actieleernetwerk.nl,actiemonitoringce.nl,adviescollegeicttoetsing.nl,adviescommissieweigerendeobservandi.nl,adviesraadinternationalevraagstukken.nl,advisorycouncilinternationalaffairs.nl,aehnet.nl,aerius.nl,afvalcirculair.nl,agendaijsselmeergebied2050.nl,agendalaadinfrastructuur.nl,agendastad.nl,agendastadenregio.nl,agendavoorhetwaddengebied2050.nl,agentschap-nl.nl,agentschap.com,agentschapnederland.nl,agentschapszw.nl,agentschaptelecom.nl,agima.nl,agressievrijwerk.nl,agroberichtenbuitenland.nl,ahn.nl,aimonline.nl,aivd.nl,ajuvico.nl,akkoordverbeteringproductsamenstelling.nl,alertonlinequiz.nl,algemene-zaken.nl,algemenebestuursdienst.nl,allebodemtoetsen.nl,alleenjijbepaalt.nl,allesisgezondheid.nl,allesoversport.nl,ambassadeursconferentie.nl,ambtelijkvakmanschap.nl,amlc.eu,amlc.nl,answerforbusiness.nl,antennebureau.nl,anti-racisme.nl,anvs.nl,apweb.nl,aquo.nl,arbeidsinspectiecn.com,arbiteraardbevingsschade.nl,arboportaal.nl,arorijk.nl,asbestvolgsysteem.nl,atde.nl,atgb.nl,atlasinfectieziekten.nl,atlasleefomgeving.nl,atlasnatuurlijkkapitaal.nl,atnfi.nl,autokinderzitjes.nl,autoriteitnvs.nl,avghelpdeskzorg.nl,avgregisterrijksoverheid.nl,awt.nl,awti.nl,basisinformatie-overstromingen.nl,basisregistratieondergrond.nl,basisregistratiesienm.nl,bco-portaal.nl,bdmuseum.nl,bedrijvenbeleidinbeeld.nl,beeldkompas.nl,beheerautoriteitwaddenzee.nl,beheerdetoekomst.nl,bekijkjepensioenregeling.nl,belandadananda.nl,belastingdienst-cn.nl,benchmarkinginthepublicsector.nl,bereiknu.nl,beschikbaarheidbijdrage-medische-vervolgopleidingen.nl,beschutaandebak.nl,bestrijdingsmiddelen-omwonenden.nl,beterbenutten.nl,bewustbodemgebruik.nl,bics.nl,bidbook.eu,biedboek.nl,big-register.nl,bigregister.nl,binnenhofrenovatie.nl,binnl.nl,biociden.nl,biodiversiteit.nl,biosecuritykwetsbaarheidsanalyse.nl,biosecurityselfscan.nl,biosecurityvulnerabilityscan.nl,biosecurityzelfscan.nl,blankenburgverbinding.nl,blauwegolfverbindend.nl,blijfpositief.nl,boa-expertisecentrum.nl,bodemambities.nl,bodemconvenant.nl,bodemloket.nl,bodemplus.nl,bodemrichtlijn.nl,bodemtoetsen.nl,bodemvizier.nl,boetebase.nl,bofeb.nl,bouwbesluit.com,bouwplaatsirm.nl,braic.nl,brandweercn.nl,brba.eu,brba.nl,brexitloket.nl,broloket.nl,bromonitor.nl,bronhouderportaal-bro.nl,brzoplus.nl,bsn-koppelregister.nl,bsv.nu,building-with-nature.eu,bun-k.nl,bureau-energieprojecten.nl,bureaubiosecurity.nl,bureauncdr.nl,bureausaneringverkeerslawaai.nl,bureautoetsinginvesteringen.nl,burgemeester-worden.nl,burgerforumkiesstelsel.nl,businessinthegcc.com,businessinthenetherlands.nl,bzkgemeentedagen.nl,bzkncc.nl,bzksocialmedia.nl,campagnetoolkits.nl,cannabisbureau.nl,canonro.nl,caopolitie.nl,caorijk.nl,cas2021.com,cas2021.nl,casareal.nl,cashbattle.nl,cashcalculator.nl,cashculator.nl,cbg-meb.nl,cbi.eu,cbi.nl,cbpweb.eu,centique.nl,centralecommissiedierproeven.nl,centraleeindtoetspo.nl,centrumgoodgovernance.nl,centruminternationaalrecht.nl,centrumvoorstandaarden.nl,cfto.nl,challengestad.nl,checkjebrexit.nl,checkjeschoolgebouw.nl,chemischestoffengoedgeregeld.nl,cibg.nl,cibgacademie.nl,cicapp.nl,circle-of-blame.nl,circularandfairictpact.com,circularfestivals.nl,cjgbon.nl,cjib.nl,clientondersteuning.co.nl,clo.nl,co2emissiefactoren.nl,co2reductie.nl,co2reductieplan.nl,cocreatesa.nl,codexalimentarius.eu,codexalimentarius.nl,cogemjaarverslag.net,collectienederland.nl,collegevanrijksadviseurs.nl,commabz.nl,commissiebbv.nl,commissiecorporategovernance.nl,commissiedewinter.nl,commissiemijnbouwschade.nl,commissievanaanbestedingsexperts.nl,communicatieplein.nl,communicatierijk.nl,compendiumvoordeleefomgeving.nl,connectingmobility.nl,consumententoezicht.nl,contactpuntbouwproducten.nl,contenttoolsrijksoverheid.nl,coordinatiestroomlijn.nl,coronacheck.nl,coronaconflict.nl,coronamelder.nl,coronatest.nl,corpgov.nl,corridoramsterdamhoorn.nl,cosmeticaklachten.nl,covidbehaviouralchallenge.nl,covm.nl,cpb.nl,creatieveindustrieinbeeld.nl,criminaliteitinbeeld.nl,crisis-management.nl,crisis.nl,crisistest.nl,csirtdsp.nl,ctivd.nl,ctpveldzicht.nl,cultureelerfgoed.nl,cultuursubsidie.nl,customsnl-insight.nl,cvom.nl,cvte-raadpleging.nl,cvte.nl,cyber-magazine.nl,cyberradar.nl,cybersecurityalliantie.nl,cybersecuritycouncil.nl,cybersecurityraad.nl,daardoenwehetvoor.nl,daarkunjemeethuiskomen.nl,dagvandeforensischezorg.nl,dashboardgroningen.nl,databank.nl,databronnencovid19.nl,datachallenge.nl,datahuiswadden.nl,datarotterdam.nl,datavoorgezondheid.nl,datawonen.nl,dcc-ienw.nl,dcypher.nl,deadelaarisgeland.nl,deafsluitdijk.nl,deaftrapop.nl,deandereoverheid.nl,debaanvanhetleven.nl,defensie.nl,defensietalenten.nl,degeitwordtgemolken.nl,dejuistezorgopdejuisteplek.nl,delerarenagenda.nl,delichtkogel.nl,deltacoalition.net,deltacommissaris.nl,deltaflexjenvmobiliteitscentrum.nl,deltaprogramma.nl,deltaroute.nl,demijnraad.nl,denationaleomgevingsvisie.nl,denkdoeduurzaam.nl,denkvooruit.nl,derijkscampus.nl,deskundigengroepdierziekten.nl,deskundigenregister.nl,destaatvanhetonderwijs.nl,deveiligheidsmonitor.nl,dewaardevanouderworden.nl,deweekvanhetgeld.nl,dggf.nl,dgv.nl,dgvcentraal.nl,dialooglaatstelevensfase.nl,dictu.nl,dictuhb.nl,dictumagazines.nl,dienstgeestelijkeverzorging.nl,dienstjustis.com,dienstterugkeerenvertrek.nl,diensttesten.nl,dienstuitvoeringonderwijs.nl,diergeneeskunderegister.nl,diergeneeskundigregister.nl,digicampus.tech,digid.nl,digikoppeling.com,digikoppeling.nl,digitaleoverheid.nl,digitaletoegang.nl,digitalezorgzandbak.nl,digitaltrustcenter.nl,digitoegankelijk.nl,digld.nl,diplomaregister.nl,directduidelijk.nl,dirkhartog2016.nl,dischargetest.com,dji-aanbestedingen.nl,dji.nl,doc-direkt.nl,doemeemetmdt.nl,domeinen.org,domeinenrz.nl,domeinnamenrijksoverheid.nl,donorgegevens.nl,donorregister.nl,donorregistratie.nl,doorstroomatlas-vmbo.nl,doortrappen.nl,douane-inzicht.nl,douane.nl,draaiboekpsie.nl,dranquilo.nl,drupaloverheid.nl,dsta.nl,dtnr.nl,duo-jaarberichten.nl,duo.nl,dus-i.nl,dustex.nl,dutch-id-documents.nl,dutchculturekorea.com,dutchcultureusa.com,dutchdigitaldelta-magazine.nl,dutchdubai.com,dutchhousingpolicy.nl,dutchoffshorewindatlas.nl,dutchrapporteur.nl,dutchroyalhouse.nl,dutchsocialmediaguide.nl,dutchwebinar.com,duurzaamdoor.nl,duurzaamgww.nl,duurzaamheidsplatform.nl,duurzaamheidsroutea35.nl,duurzameinzetbaarheid.nl,duurzamelandbouw.nl,dv2030.nl,dwangindezorg.nl,dynamo-hia.eu,e-alert.nl,e-cert.nl,e-herkenning.nl,e-mjv.nl,e-rihs.nl,earonline.nl,ec-hrm.nl,eentegeneenzaamheid.nl,eenzaam.nl,eerenvrijheid.nl,efeat.org,eherkenning.nl,eidstelsel.nl,eiti.nl,elonext.nl,emaddc.com,emissieautoriteit.nl,emissieregistratie.nl,emissionsauthority.nl,emnnetherlands.nl,en16001.nl,energiebesparingindezorg.nl,energiecijfers.nl,energieoprijksgrond.nl,energierijkdenhaag.nl,energiesubsidiewijzer.nl,enterpriseeuropenetwork.nl,enwinfo.nl,ep-online.nl,equal-life.eu,eranetbioenergy.net,erfgoeddeal.nl,erfgoedinspectie.nl,erfgoedmonitor.nl,ertms.nl,etoegang.nl,eu-alert.nl,eu2016.nl,eu2030.nl,eualert.eu,eualert.nl,euandgvc.nl,eumetcal.eu,eunethta.eu,euphix.org,eurlsalmonella.eu,europeanpartnership-responsibleminerals.eu,eurovignettes.eu,euthanasiecommissie.nl,evaluatiecaribischnederland.nl,evaluationdutchcaribbean.nl,evdinternationaal.nl,examenblad.nl,examenbladmbo.nl,excellentegebieden.nl,excellentescholen.nl,expeditierws2050.nl,expertisecentrumlyme.nl,expertisecentrummggz.nl,expertisecentrumwarmte.nl,expertteameigenbouw.nl,ezli.nl,ezoefapp.nl,faculteitmilitairewetenschappen.nl,fairproject.org,farmacotherapeutischkompas.nl,farmatec.nl,faststartfinance.nl,fcinet.org,federatieveservice.nl,feedfoodtransfer.nl,festivalforensischezorg.nl,financialtrainee.nl,financialtraineebijhetrijk.nl,financialtraineeship.nl,financieelfittewerknemers.nl,financieeltraineeship.nl,financien4school.nl,findo.nl,fiod.nl,fitopjouwmanier.nl,flex-sparen.nl,flexchange.nl,flexsparen.nl,flitspanel.nl,fmhaaglanden.nl,forensicinstitute.nl,forensischezorg.nl,forensischinstituut.nl,formuleeteam.nl,formulierdus-i.nl,forumstandaardisatie.nl,fpdjeugd.nl,functiegebouwrijksoverheid.nl,functiemix.nl,functieruilrijk.nl,gatewayreview.nl,gddiergezondheid.nl,gebruikercentraal.nl,gegevensuitwisselingindezorg.nl,geldlessen.nl,geleacademie.nl,gelijke-kansen.nl,geluidregisterspoor.nl,geobasisregistraties.nl,ger-ned380kv.nl,gerechtelijkebrief.nl,gerechtelijkebrieven.nl,gerechtelijklaboratorium.nl,gerned380.nl,gerned380kv.nl,geschilleninstantieszorg.nl,gezondekinderopvang.nl,gezondeleefomgeving.nl,gezondeschool.nl,gfcecontact.com,ggo-vergunningverlening-zoeken.nl,ggo-vergunningverlening.nl,ghs-helpdesk.nl,gipdatabank.nl,globalforumoncyberexpertise.com,globalforumoncyberexpertise.nl,globemission.eu,globio.info,gobiernodireino.nl,gobiernudireino.nl,golfhoogte.nl,gordelsom.nl,gov-dns.nl,gov4nano.eu,govbox.nl,govdns.nl,government.nl,gratisvog.nl,greendeals.nl,greentransporthub.org,grieppandemie.nl,grondstoffenscanner.nl,guaranteeforum.eu,haaglandenpolitie.nl,handelingenbank.info,hansken.nl,hansken.org,heil-hitler.nl,helpdesk-efactureren.nl,helpdeskbouwregels.nl,helpdeskwater.nl,hepatitis-and-u.nl,hepatitisonderzoek.nl,hetbegintmetaal.nl,hetfinancieelloket.nl,hetkaninhetonderwijs.nl,heyhetisoke.nl,higherlevel.nl,his-ict.nl,hoewerktnederland.com,hoewerktnederland.nl,hoewerktnl.com,holandaevoce.nl,holandanomundo.nl,holandawaanta.nl,hollandavesen.nl,hollandnationalparks.com,hollandtrade.com,hoogspanningsverbinding.nl,hoogspanningsverbindingen.nl,horecarookvrij.nl,horizonscangeneesmiddelen.nl,huiselijkgeweld.nl,huisstijlvannix.nl,huisvoordemocratie.nl,hulpbijondernemen.nl,hulpmiddelenwijzer.nl,hulpmiddelenzorg.nl,humanrightstulip.nl,huurprijscheck.nl,hwbp.nl,iamcdocumentation.eu,iasa2011.nl,ictsectoren.nl,idencys.nl,idensys.com,idensys.eu,identiteitsdocumenten.nl,iedereendoetwat.nl,iedereenondereendak.nl,ienc-kennisportaal.nl,ienw-datadagen.nl,igj.nl,igjacademie.nl,ihw.nl,iinterimrijk.nl,ikdraaggeenwapen.nl,ikpasophetwad.nl,ikvalop.nl,ikvermoedhuiselijkgeweld.nl,ikz.nl,ilent.nl,ilentiod.nl,immigratie-naturalisatiedienst.nl,immigratieennaturalisatiedienst.nl,immissietoets.nl,in-made.nl,inburgeren.nl,incca.org,incidentmanagement.nl,ind.nl,indjaarverslag.nl,industrialtechnologies2016.eu,info-ro.nl,infomil.nl,inforijk.nl,informatieberaadzorg.nl,informatiehuishouding.nl,informatiehuismarien.nl,ingesprekmetnederland.nl,inkoopsociaaldomein.nl,inmade.nl,innova58.nl,innovatie-estafette.nl,innovatiefondsmkb.nl,innovatiekrediet.nl,innovatietoezicht.nl,innovation-expo.eu,innoveermeemetjenv.nl,innovember.nl,inspectie-checklist.nl,inspectie-jenv.nl,inspectie-oe.nl,inspectie-publicaties.nl,inspectielandschap.nl,inspectieresultatenszw.nl,inspectieszw.eu,inspectieszw.nl,inspectieview.nl,inspectiewerkt.nl,inspectorateszw.nl,inspireaanmerking.nl,interbestuurlijkelasten.nl,interimmanagementrijk.nl,internationaalondernemen.nl,internationalerechtshulp.nl,internetconsultatie.nl,internetpillen.nl,internetspiegel.nl,internetstemburo.nl,interspeciesinfo.com,investinholland.com,iob-evaluatie.nl,iplo.nl,ishetafval.nl,istandaarden.nl,it-academieoverheid.nl,its-corridor.com,its-corridor.nl,iuc-noord.nl,ivd.nl,jaarberichtrijkswaterstaat.nl,jaarverantwoordingzorg.nl,jaarverslagenrvo.nl,jaofnee.nl,jenvconnect.nl,jeugdautoriteit.nl,jeugdconnect.nl,jeugdengezin.nl,jokesmitprijs.nl,jonglereneten.nl,justid.nl,justis.nl,justitie.nl,justitieconnect.nl,justitieleictorganisatie.nl,kabga.aw,kabinetsformatie2010.nl,kabinetsformatie2012.nl,kabinetvandekoning.nl,kamervoordebinnenvisserij.nl,kansrijkestartnl.nl,kansrijkgroningen.nl,kansspelautoriteit.nl,kcwj.nl,kemprogramma.nl,kenniscentrum-oo.nl,kennisknooppuntparticipatie.nl,kennisnetwerkbiociden.nl,kennisnetwerkspv.nl,kennisopenbaarbestuur.nl,kennisplatform.nl,kennisplatformveehouderij.nl,kennisplatformvhg.nl,kennisplatformwerkeninkomen.nl,keringhuis.nl,kiesdefiets.nl,kiezen-en-delen.nl,kijkenoverdegrens.nl,kijkopeuropa.nl,kik-starter.nl,kik-v.nl,kimnet.nl,kinderbescherming.nl,klimaatadaptatienederland.nl,klimaatakkoord.nl,knmi.nl,knmidata.nl,knmidc.org,knmiprojects.nl,knooppunt-hoevelaken.nl,knooppuntjoure.nl,komuitjeschuld.nl,komveiligthuis.nl,koninklijkhuis.nl,kosteneffectiviteitvanpreventie.nl,krijgiktozo.nl,krmportaal.nl,krmrapportagetool.nl,kwaliteitsafsprakenmbo.nl,laamagazine.nl,lancewadplan.nl,landelijkeadviescommissieplaatsing.nl,landelijkregisterkinderopvang.nl,lap3.nl,lavsinfo.nl,lchulpmiddelen.nl,leefbaarometer.nl,leer-rijk.nl,leerplatformmirt.nl,leerportaalienw.nl,lees-rijk.nl,leidraadse.nl,lerarenportfolio.nl,leren-werken.nl,lerenenwerken.nl,lerenvoorveiligheid.nl,levjenv.nl,life-ip-deltanatuur.nl,lma.nl,locov.nl,logius.nl,lokaalklimaatportaal.nl,lokale-democratie.nl,loketgentherapie.nl,loketgezondleven.nl,luchtvaartindetoekomst.nl,luchtvaartmeteo.nl,lzalp.nl,maakhetzeniettemakkelijk.nl,maatwerkvoormensen.nl,magazinesrijkswaterstaat.nl,maraz.nl,maritiemehavenenbinnenhavenmonitor.nl,matra-south.nl,medicijnkosten.nl,medregeu2016.nl,meermetminderplastic.nl,meerwetenoverzorg.nl,meetingpointdji.nl,meldcode.nl,meldennieuwezorgaanbieders.nl,meldknop.nl,meldpuntbodemkwaliteit.nl,meldpuntzorgwekkendgedrag.nl,mensenrechtentulp.nl,metenvanduurzaamheid.nl,mett.nl,mfaservices.nl,mi-cert.nl,microfoonbanden.nl,mijnbouwvergunningen.nl,mijncoronaprotocol.nl,mijneindexamen.nl,mijnontwikkelhuis.nl,mijnpgb.nl,mijnslachtofferzaak.nl,mijnverblijfsdocument.nl,mijnwerkenzekerheid.nl,milieuzones.nl,minaz.nl,minbuza.nl,mindergrondrisico.nl,mineli.nl,minfin.nl,minienm.nl,minienw.nl,minjenv-events.nl,mirta15papendrechtgorinchem.nl,mirta20nieuwerkerkgouda.nl,mirta2deilvught.nl,mirta67leenderheidezaarderheiken.nl,mirtnowa.nl,mirtoostkantamsterdam.nl,mirtoverzicht.nl,mirtprojectenboek.nl,mirttrajecten.nl,mirtverkenninga1-a30.nl,missionsustainable.nl,mjpo.nl,mkdoorn.nl,mnp.nl,mobiliteitsbank.nl,mobiliteitsscan-info.nl,mobilityhappiness.nl,mobilitylab.nl,moderniseringmonumentenzorg.nl,modernisinggovernment.com,modernisinggovernment.net,moederbrigade.nl,moneywiseplatform.nl,monitor-nederlanddigitaal.nl,monitorgezondheid.nl,monitorlangdurigezorg.nl,monozakelijk.nl,monumenten.nl,move-rdh.nl,muncasiviatainolanda.nl,mvicongres.nl,mvicriteria.nl,n35wijthmennijverdal.nl,n3werkzaamheden.nl,naarnederland.nl,nas-adaptatietool.nl,nationaalcoordinatorgroningen.nl,nationaalcoordinatorterrorismebestrijding.com,nationaalcoordinatorterrorismebestrijding.nl,nationaalgroeifonds.nl,nationaalovberaad.nl,nationaalrapporteur.nl,nationaalwaterstofprogramma.nl,nationalacademy.nl,nationale-veiligheid.nl,nationaleenergieatlas.nl,nationaleiconen.nl,nationaleopendagdji.nl,nationaleparkenvanwereldklasse.nl,nationalevisiekust.nl,nationalicons.nl,natura2000.nl,natura2000waddengebied.nl,natuurlijkveilig.nl,nazorgjeugd.nl,nbso-brazil.com.br,nbso-texas.com,ncadierproevenbeleid.nl,ncgroningen.nl,ncpeh.nl,ncsc.nl,nctv.eu,nctv.nl,nctvminvenj.nl,ndpa.nl,ndw.nu,nederlandcallcenter.nl,nederlandenu.nl,nederlandse-sportraad.nl,nederlandservice.nl,nederlandsinvesteringsagentschap.nl,nederlandveilig.net,nederlandveilig.nl,nederlandwereldwijd.nl,nedmextrade.com,neia.eu,neorah.nl,netherlandsandyou.nl,netherlandsinvestmentagency.nl,netherlandsworldwide.nl,netwerkconsument.nl,netwerkconsumenten.nl,netwerkplatteland.nl,nfi-academy.nl,nfi-fieldlab.nl,nfi-services.nl,nfinuclearforensics.eu,nfinuclearforensics.nl,nictiz.nl,niderlandy-i-vy.nl,niederlandeweltweit.nl,nieuwecoalitiesvoordewijk.nl,nieuwinnl.nl,nieuwkiesstelsel.nl,nieuwsbriefdor.nl,nieuwsbrievenminocw.nl,nieuwsbzk.nl,nieuwsienw.nl,nieuwsszw.nl,nifp.nl,niks18.nl,nimbuza.nl,nix18.nl,niyuhelan.nl,nl-works.nl,nl16.eu,nl2016.eu,nlagriculture.nl,nlbijio.nl,nldesignsystem.nl,nldevelopment.nl,nldigitalgovernment.nl,nleducation.nl,nleia.com,nleia.eu,nleia.nl,nlenergieenklimaat.nl,nlenergyandclimatechange.nl,nlevdinternationaal.nl,nlevdinternational.nl,nlexporteert.nl,nlflag.nl,nlguts.nl,nlinnovation.nl,nlintheusa.com,nlinvesteringen.nl,nllandbouw.nl,nlmobiliteit.nl,nloctrooicentrum.nl,nlonderwijsenarbeidsmarkt.nl,nlontwikkelingssamenwerking.nl,nlpatentoffice.nl,nlplatform.com,nlprivatesectordevelopment.nl,nlpromotion.nl,nltoerisme.nl,nltoerismeenpromotie.nl,nltourismandpromotion.nl,nltr2012.nl,nltradeandinvest.nl,nltradeeninvest.nl,nlvalidatie.nl,nlww.nl,nmbf.nl,nmdc.eu,noddji.nl,nomorefoodtowaste.nl,noordzeeloket.nl,northseaportal.eu,northseaportal.nl,nost-france.org,notaruimte.nl,novistukken.nl,nponderwijs.nl,nppa.nl,nsl-monitoring.nl,nss-2014.nl,nuansa.nl,nuclearforensics.nl,nunietzwanger.nl,nvwa.nl,ocw-verhalen.nl,ocwincijfers.nl,odc-noord.nl,oecdguidelines.nl,oefenjestem.nl,oesorichtlijnen.nl,officielebekendmakingen.nl,oidji.nl,omgaanmetdepressie.nl,omgevingsloket-online.nl,omgevingsloket.nl,omgevingsloketonline.nl,omgevingswetportaal.nl,omgevingswijzer.org,on2013.nl,onbedoeldzwanger.info,ondernemeninbahrain.com,ondernemeninbahrein.com,ondernemenindegolf.com,ondernemeninhetmiddenoosten.com,ondernemeninkoeweit.com,ondernemeninkuwait.com,ondernemeninoman.com,ondernemeninqatar.com,ondernemeninsaoediarabie.com,ondernemeninsaudiarabie.com,ondernemeninvae.com,ondernemersloket.nl,onderwijsincijfers.nl,onderwijsinderegioincijfers.nl,onderwijsinspectie.nl,one-conference.nl,onehealth.nl,onswater.nl,ontdekdezorg.nl,ontwerpwedstrijdmiljoenennota.nl,onzedelta.nl,onzeoverheid.nl,opdrachtgeversforum.nl,open-overheid.nl,opendata-award.nl,openkat.nl,opkaart.nl,opleidingsinstituutdji.nl,opnieuwthuis.nl,opsporingszw.nl,opwegmetwaterstof.nl,opwegnaarseb.nl,opwegnaarzes.nl,orandatowatashi.nl,orange-directory.com.ua,ordz.nl,orfeus-eu.org,organisatierijksdienst.nl,osresultaten.nl,oteam.nl,oudersenschoolsamen.nl,outilevaluationbiosecurite.nl,overalsnelinternet.nl,overalstemmen.nl,overheid.nl,overheidinuitvoering.nl,overheidsvideo.nl,overheidvannu.nl,overlegorgaanfysiekeleefomgeving.nl,overstroomik.nl,owinsp.nl,p-direkt.nl,paisesbajosmundial.nl,paisesbajosytu.nl,papilionem.nl,paysbasetvous.nl,paysbasmondial.nl,pbl.nl,penitentiaireinrichting.nl,pensioen3daagse.nl,peppolautoriteit.nl,perined.nl,permanentevertegenwoordigingen.nl,permanentrepresentations.nl,personenregisterkinderopvang.nl,pgunet.nl,piamsterdam.nl,pideijssel.nl,pidordtsepoorten.nl,pilotdtt.nl,piterapel.nl,pitorentijd.nl,pki-overheid.nl,pkioverheid.nl,placesofhope.nl,platformafvalcirculair.nl,platformduurzaamheid.nl,platformduurzaamovenspoor.nl,platformduurzamehuisvesting.nl,platformhoutrook.nl,platformjep.nl,platformkringlooplandbouw.nl,platformparticipatie.nl,platformrijksoverheidonline.nl,platformwow.nl,pleinbzk.nl,pleio.nl,plusvws.nl,pmkapp.nl,pmkmodellen.nl,pns.nl,politiekeambtsdragers.nl,poraad.nl,portalfitopjouwmanier.nl,postedworkers.nl,pppdutchgovernment.nl,praktijkproefamsterdam.nl,prestatiemeten.nl,prettigcontactmetdeoverheid.nl,prinseslaurentien.nl,prinsjesdag2013.nl,prinsjesdag2015.nl,prinsjesdag2016.nl,prinsjesdagtool.nl,privacytoezichthouder.nl,procesinfrastructuur.nl,processierups.nu,processinnovation.nl,professioninperspective.nl,prognosemodelzw.nl,programmalangerthuis.nl,programmamenscentraal.nl,programmasociaaldomein.nl,proimg.nl,psiprogramme.nl,publiektoezicht.nl,pulsefishing.eu,puurrookvrij.nl,q-bankplants.eu,qa4ecv.eu,quicktelecomscan.nl,rabarijk.nl,ramp.nl,randstad380kv-noordring.nl,randstad380kv-zuidring.nl,referentiegrootboekschema.nl,regelsvoordieren.nl,regioatlas.nl,regiobeeld.nl,regioburgemeesters.nl,registerexterneveiligheid.nl,rekenhulptransitievergoeding.nl,rekenopgaven-etalage.nl,rijksacademie.nl,rijksappstore.nl,rijksbegroting.nl,rijksbeveiliging.nl,rijksbeveiligingsorganisatie.nl,rijksbrededienstverleners.nl,rijksbredekennisagenda.nl,rijkscloud.nl,rijksdienstcaribischnederland.nl,rijksfinancien.nl,rijkshuisstijl.nl,rijksictdashboard.nl,rijksictgilde.nl,rijksinnovatiecommunity.nl,rijksinspecties.nl,rijksnormering.nl,rijksoverheid.nl,rijksoverheid20.nl,rijksoverheidnl.eu,rijksoverheidnl.nl,rijkspand.nl,rijksportaal.nl,rijksschoonmaak.nl,rijksvaccinatieprogramma.nl,rijksvastgoedbedrijf.nl,rijkswaterstaat.nl,rijkswaterstaatdata.nl,rijkswaterstaatstrooit.nl,risicokaart.nl,risicoregelreflex.nl,risicotoolboxbodem.nl,rivm.nl,rivmmagazines.nl,roimg.nl,rookvrijcafe.nl,rovid.nl,row-minvws.nl,royal-house.nl,russiaholland2013.nl,rvdk.nl,rvdkdestemvanhetkind.nl,rvig.nl,rvo.nl,rvomagazines.nl,rws.nl,rwscirculair.nl,rwscregelaar.nl,rwsduurzamemobiliteit.nl,rwseconomie.nl,rwsenvironment.eu,rwsinnoveert.nl,rwsnatura2000.nl,rwssportdag.nl,rwsverkeersinfo.nl,ryksoverheid.nl,safe-by-design-nl.nl,samenmetenaanluchtkwaliteit.nl,samenwerkenaanontwerpkracht.nl,samenwerkenaanriviernatuur.nl,sanctieuitvoering.nl,savewildlife.nl,sawa-vth.nl,sbr-nl.nl,sbr-wonen.nl,sbv-z.nl,schadedoormijnbouw.nl,schakeldagen.nl,schatkistbankieren.nl,schelde-ecs.nl,scherpeblik.nl,schoneluchtakkoord.nl,schonerivieren.org,schoolleidersregister.nl,schoolleidersregisterpo.nl,schoolleidersregistervo.nl,schoolrapporten.nl,schoonlicht.nl,schoudersonderschoon.nl,sciorijk.nl,scp.nl,sds-check.nl,sectorplannen.nl,securenovember.nl,sentik.nl,serviceinfoapp.nl,servicenederland.nl,sieunddieniederlande.nl,signaaldigitaal.nl,signalenleefomgeving.nl,signaleringleefomgevingengezondheid.nl,slim-onderhoud.nl,slimmest.nl,slimmezorgestafette.nl,slimmezorgestafette2022.nl,slimwatermanagement.nl,smartgovernance.nl,snuffle.org,sociaalfondsminienw.nl,socialemediagidsbz.nl,socialestabiliteit.nl,socrates2.org,soda2016.nl,sodm.nl,solarhighways.eu,spaceoffice.nl,spercc.nl,sportakkoord.nl,sportenbewegenincijfers.nl,sportinnovator.nl,ssc-campus.nl,ssc-ict.nl,ssc-ictspecials.nl,ssci.nl,sso-noord.nl,sso3w.nl,staatdernederlanden.nl,staatsexamensnt2.nl,staatsexamensvo.nl,staatssecretarisheemskerk.nl,staatvanhetbestuur.nl,staatvenz.nl,stagefondszorg.nl,startmetoesorichtlijnen.nl,startstuderen.eu,startstuderen.nl,stelselcatalogus.nl,stembureauinstructie.nl,steunpuntcoronazorgen.nl,stimva.nl,stopdebureaucratie.nl,stopdeovervaller.nl,strafrechtketen.nl,stroopjemouwop.nl,studeermeteenplan.nl,studentendag.nl,stvlab.nl,sustainabilitymethod.com,sustainabilitymethod.eu,sustainabilitymethod.nl,suurhoffbrug.nl,szw.eu,szwkerncijfers.nl,taalakkoord.nl,talentisbelangrijker.nl,tbs-inrichting.nl,tbsgestelden.nl,tcbodem.nl,teebstad.nl,tegengaanradicalisering.nl,telmeemettaal.nl,temis.nl,tenderned.nl,testenvoortoegang.org,testuitvoeringarbeidsvoorwaardenwetgeving.nl,tfsagency.nl,thegfce.com,theventilators.nl,tlokb.nl,toegangocw.nl,toegangsociaaldomein.nl,toegangspuntmobiliteit.nl,toegangtotdeoverheid.nl,toegankelijkheidsverklaring.nl,toekomstglb.nl,toekomstreligieuserfgoed.nl,toekomstvandezorg.nl,toetredingzorgaanbieders.nl,toetsingscommissievp.nl,toezichtfestival.nl,toezichtresultaten.nl,toezichtsociaaldomein.nl,toolboxbeleidsevaluaties.nl,toolboxinclusief.nl,toolkitomgevingswet.nl,topcorridors.com,topinkomens.nl,topsectoragrifood.nl,topsectoren.nl,topsectorenergie.nl,topshuis.nl,tradeandinnovate.nl,trainingscatalogus.nl,transitiecommissiesociaaldomein.nl,transitieproefdiervrijeinnovatie.nl,transparantiebenchmark.nl,transparencybenchmark.eu,trendsinbeeldocw.nl,tst-rds.nl,tuchtcollege-gezondheidszorg.nl,ubrijk.nl,uitkomstgerichtezorg.nl,uitvoeringarbeidsvoorwaardenwetgeving.nl,uitvoeringvanbeleidszw.nl,ukomttochweer.nl,un-psf2017.com,usar.nl,uspb-depeevee.nl,uwbeslagvrijevoet.nl,uwlast.nl,uziregister.nl,vaarweginfo.nl,vaarweginformatie.nl,validatie.nl,valuingwaterinitiative.org,vananaarbeter.nl,vananaloognaardigitaal.nl,vang-hha.nl,vangbuitenshuis.nl,vastgoedvanhetrijk.nl,vechtscheidingen.nl,veiligepubliekedienstverlening.nl,veiligheidbegintbijvoorkomen.nl,veiligheidshuisdordrecht.nl,veiligheidsinterventies.nl,veiliginternetten.nl,veiligtatoeerenenpiercen.nl,veiligvakmanschap.nl,vera-2r.nl,verantwoordalcoholverkopen.nl,verantwoordmesttransport.nl,verantwoordmestvervoer.nl,verbeter-direkt.nl,verbeterjehuis.nl,verderkijkers.nl,verduurzamingindustrie.nl,vergroendezorg.nl,verkeersgegevens.nl,verkeersonderneming.nl,verkeersveiligheidscampagnes.nl,verkiezingen2007.nl,verkiezingen2008.nl,verkiezingen2009.nl,verkiezingen2011.nl,verkiezingen2013.nl,verkiezingennederland.nl,verlofadviescollege.nl,verlofregelaar.nl,vernieuwingforensischezorg.nl,verrekeningneveninkomsten.nl,versnellingshuisce.nl,vervoerenondersteuning.nl,verwijzingsportaalbankgegevens.nl,veterinairberoepscollege.nl,veterinairtuchtcollege.nl,veva.nl,via1400.nl,via15.nl,vib-check.nl,vic2016.nl,vipasbest.nl,virtuelebajes.nl,vliegtuiggeluid.nl,vnsc.eu,voedselenwarenautoriteit.nl,volksgezondheidenzorg.info,volksgezondheidtoekomstverkenning.nl,volwaardig-leven.nl,voorbeeldwoningen.nl,voordejeugd.nl,vptbeurs2010.nl,vrachtwagenheffing.nl,vreemdelingendocumenten.nl,vreemdelingenvisie.nl,vtv2018.nl,vwscongresmagazine.nl,waardenennormendebat.nl,waarderingskamer.nl,waardigheidentrots.nl,waarzitwatin.nl,wabes.nl,waddenatlas.nl,waddenzee.nl,wanbetalerszorgpremie.nl,watdevog.nl,wateetnederland.nl,waterasleverage.org,waterbeschikbaarheid.nl,waterbodemrichtlijn.nl,waterenklimaat.nl,watermarkt.nl,waterveiligheidsportaal.nl,waterverhalen.nl,watisdeslimmemeter.nl,watkanmijhelpen.nl,watvooreeneikelbenjij.nl,watvoorhandhaverbenjij.nl,watvoorloserbenjij.nl,wcefplusclimate.com,webinar-windturbines.nl,websiteregisterrijksoverheid.nl,weekvanhetgeld.nl,weerbaarbestuur.nl,weerbaredigitaleoverheid.nl,wegtotdewetenschap.nl,wegwijzermensenhandel.nl,werkaanuitvoering.nl,werkenbijdeeu.nl,werkenbijdeoverheid.nl,werkenbijdji.nl,werkenvoorderijksoverheid.nl,werkenvoorinternationaleorganisaties.nl,werkenvoornederland.nl,wetbeschermingklokkenluiders.nl,wetlz.nl,wetswijzigingen.nl,whofic.nl,wijzeringeldzaken.nl,wijzermetgeldzaken.nl,windopzee.nl,wkotool.nl,wlo2015.nl,wodc-repris.nl,wodc.nl,woningmarktbeleid.nl,woononderzoek.nl,wordtaakstrafbegeleider.nl,workinnl.nl,wozep.nl,wpfc2020.com,wtzi.nl,youthatheart.nl,zakendoeninbahrain.com,zakendoeninbahrein.com,zakendoeninchina.org,zakendoenindegolf.com,zakendoenindevae.com,zakendoeninhetmiddenoosten.com,zakendoeninkoeweit.com,zakendoeninkuwait.com,zakendoeninoman.com,zakendoeninqatar.com,zakendoeninsaudiarabie.com,zakendoenmetbzk.nl,zeeweringen.nl,zeeweringenwiki.nl,zelfinspectie.nl,zeroemissiedoelgroepenvervoer.nl,zibs.nl,zichtopiederkind.nl,zijnjullieeraluit.nl,zoekscholen.nl,zonmw-jeugdmagazines.nl,zorgcijfersdatabank.nl,zorgcsp.nl,zorgengezondheid.nl,zorginstituutnederland.nl,zorginzicht.nl,zorgopdekaart.nl,zorgvannu.nl,zorgverzekeringslijn.nl,zorgvoorinnoveren.nl,zovar.nl,zuid-west380kv.nl,zwdelta.nl,zwemwater.nl
Grab|grab.careers,myteksi.net,myteksi.com,grab.co,grab.com,grabpay.com,grabtaxi.com
Grammarly|grammarly.com,grammarly.ai,grammarly.io,grammarly.net
Greenhouse.io|greenhouse.events,greenhouse.io
Grindr|grindr.io,grindr.com,grindr.mobi
Grofers|grofers.com
Groww|groww.in
Gymshark|gymshark.com,gymshark.io
H&M Group|hm.com,cos.com,weekday.com,monki.com,arket.com,afound.com,stories.com
H1-CTF|h1ctf.com
Hackchecks|hackchecks.in
HackenProof|hackenproof.com
HackerRank|hackerrank.com
Hake Finance|hakka.finance,igain.finance
Hanno|betterscience.org,fuzzing-project.org,hboeck.de
Harvard|harvard.edu
Harvest|forecastapp.com,getharvest.com,harvestapp.com
Helium|helium.systems,helium.com
Hilton Bounty|hilton.com,hilton.io,hilton.com.tr,hiltonbusinessonline.com,hiltonjapan.co.jp,hiltonmanage.com
Hootsuite|hootsuite.com,ow.ly
Host Gator|hostgator.com.br,hostgator.mx,hostgator.cl,hostgator.co,hostgator.io,hostgator.com
Hostinger|hostinger.com,zyro.com,hosting24.com
Hotbit|hotbit.io
HTC|htc.com
Huawei|hicloud.com,vmall.com,huawei.com,huaweicloud.com
Humble Bundle|humblebundle.com
Huobi|huobi.com
Hy-Vee|hy-vee.com
Hyatt|hyatt.com
Hyperledger|hyperledger.org
IBM|ibm.com
Ibotta|ibotta.com,ibops.net
IKEA|ikea.com
Imgur|imgur.com
ImpactGuru|impactguru.com
Indeed|indeed.com,indeed.tech
INDmoney|indmoney.com,indiawealth.in
inDrive|indriver.com
Infogram|infogram.com
Informatica|informatica.com
ING Bank|ing.com,ing.nl
Insolar|insolar.io
Instacart|instacart.com,instacart.tools
Instamojo|instamojo.com
Insulet Corporation|myomnipod.com,poddercentral.com
Intercom|intercom.io
Internet NL|internet.nl
Intigriti|intigriti.com
Intuit|intuit.com,turbotax.com,mint.com,quickbooks.com,mailchimp.com
InvestNext|investnextdemo.co,investnext.com
InVision|muz.li,invisionapp.com
IoTeX|iotex.io,iotexscan.io,iotexscout.io,machinefi.com,iopay.me
IOVLabs|rsk.co
IRCCloud|irccloud.com,irccloud-cdn.com
Issuu|issuu.com
Itslearning|itslearning.com
Ivanti|ivanti.com
JamieWeb|jamiewebgbelqfno.onion,jamieweb.net,jamie3vkiwibfiwucd6vxijskbhpjdyajmzeor4mc4i7yopvpo4p7cyd.onion
JD.COM|jd.com,360buy.com
JetBlue|jetblue.com
Jfrog|jfrog.com,jfrog.org
Jimdo|jimdo.com,jimdofree.com,jimdosite.com,jimdo-platform.net
Jivochat|jivosite.com
John Deere|johndeere.com,deere.com,jdisonline.com
JOJO|jojo.exchange
Jooki|jooki.rocks,muuselabs.com
Kartpay|kartpay.com
Keeper Security|keepersecurity.com,keepersecurity.eu
Kenna Security|kennasecurity.com
Khan Academy|khanacademy.org
Kindred Group|bingo.com,casinohuone.com,mariacasino.com,unibet.casino,storspiller.com,kolikkopelit.com,unibet.com,32red.com,unibet.fr,kindredext.net,ottokasino.com,stly.eu,maria.casino,unibet.me,vladcazino.ro,igame.com
KIWI.KI GmbH|kiwi.ki
Koho|koho.ca,koho.app
Kopikas Entertainment|slots.io
Kraden|dragonapp.io,getdragon.ch
Kraken|kraken.com,cryptowat.ch,cryptofacilities.com,cfbenchmarks.com
Kubernetes|kubernetes.io,k8s.io,gcr.io
Kucoin|kucoin.com
Kuna Crypto Exchange|kuna.io
LANCHAIN.IO|lachain.io,ladex.exchange
Larksuite|larksuite.com,byteoversea.com
LastPass|lastpass.com
Latoken|latoken.com
LCX|lcx.com
Legal Robot|legalrobot-test.com,legalrobot.com
Lemlist|lemlist.com
Lets Build|letsbuild.com
Liberapay|liberapay.com,liberapay.org
Lido Finance|lido.fi
LifeOmic|lifeomic.life,lifeomic.com,jupiterone.io
LINE|line.me,line-apps.com,naver.jp
Linktree|odesli.co,song.link,album.link,artist.link,pods.link,playlist.link,mylink.page,linktree-extensions.com,tr.ee,linktree.com,odesli.com,songlink.io
LiquidWeb|liquidweb.com
Livestream|livestream.com
Lob|lob.com,lob-assets.com
Localize|localizestaging.com,localize.live
LocalTapiola|lahitapiola.fi,lahitapiola.mobile,lahitapiolarahoitus.fi,tapiola.fi
Logitech|logi.com,streamlabs.com,teambeyond.net,challonge.com,playmaster.gg,logitech.com,logitechg.com,logitech-partner.com,jaybirdsport.com,ultimateears.com,astrogaming.com,ultimateearsuniversity.com,mysqueezebox.com,logitechmusic.com,logitechauthorization.com,logitech-channel-marketing.com,logitech.com.cn,harmonyremote.com,slimdevices.com,uesmartradio.com,logitechstore.com.br,myharmony.com,lukwerks.com,cognitiveperformer.com,logitech.io
LogMeOnce|logmeonce.com
Lyst|lystit.com,lyst.com,lyst.co
Magento|magento.com,magento.cloud,magentocommerce.com,magentolive.com
Magisto|magisto.com
Mailtrack.io|mailtrack.io
Make|make.com
MakeMyTrip|makemytrip.com
MakerDAO Ecosystem|makerdao.com
Mapbox|mapbox.com
MariaDB|mariadb.org
Marriott|marriott.com,marriott.co.uk,starwoodhotels.com,ritzcarlton.com,eleganthotels.com,marrtool.com
Mars VDP|mars.com,marschocolate.com,mms.com,pedigree.com,twix.com,orbitgum.com,dovechocolate.com,extragum.com,whiskas.com,royalcanin.com,skittles.com,royal-canin.com,bluepearlvet.com,banfield.com,vcahospitals.com
MasterCard|mastercard.ch,mastercard.nl,mastercard.ru,mastercard.us,simplify.com
MasterCard VDP|priceless.com,mastercard.com,bezcenneniespodzianki.pl,citypossible.com,mastercard.com.au,investmentmojo.com,mastercard.com.br,mastercard-lounge.cz,mastercardbiz.com,mastercard.co.za,no-minimums.com.au,pricelessspecials.nl,pricelesssurprises.com,taptotokyo.com,tasteofpremium.jp,mastercardbiz.ca
Matomo|matomo.org,innocraft.cloud
Maximum|evonik.com,devmaximum.com,maximum.nl,werkenbijdefensie.nl,werkenbijderet.nl,werkenbijbakertilly.nl
McDelivery|mcdelivery.co.in
MediaMarktSaturn|mediamarkt.at,mediamarkt.be,mediamarkt.ch,mediamarkt.com.tr,mediamarkt.de,mediamarkt.es,mediamarkt.gr,mediamarkt.hu,mediamarkt.nl,mediamarkt.pl,mediamarkt.pt,mediamarkt.se,mediaworld.it,saturn.at,saturn.de,saturn.lu
Meituan|meituan.com,meituan.net,dianping.com,neixin.cn
Mendix|mendix.com
MercadoLibre|mercadolibre.com
Microsoft Online Services|office.com,live.com,onedrive.com,office365.com,sharepoint.com,lync.com,yammer.com,sway.com,microsoft.com,live.net,skype.com
MobiKwik|mobikwik.com
Mobile DE|mobile.de
MobiSystems Ltd|mobisystems.office
Mollie|mollie.com
MON ESPACE SANT√â|monespacesante.fr
Monarch Money|monarchmoney.com
Monash MBB|monash.edu
Moneybird|moneybird.com,moneybirdstorage.com
Moneytree KK|getmoneytree.com,moneytree.jp
MongoDB|mongodb.com
Monolith|tkn.zone
MoonPay|moonpaycloud.com,hypermint.com,moonpay.com
MovieXChange|moviexchange.com
MTN Group|areeba.com.gn,irancell.ir,lonestarcell.com,mtn.bj,mtn.ci,mtn.cm,mtn.co.rw,mtn.co.sz,mtn.co.ug,mtn.co.za,mtn.com.af,mtn.com.gh,mtn.com.ye,mtn.sd,mtnblog.co.za,mtnbusiness.com,mtnbusiness.com.ng,mtncameroon.net,mtncongo.net,mtnfootball.com,mtnonline.com,mtnplay.co.za,mtnzakhele.co.za,mtnzambia.co.zm,mtn.com,mtngbissau.com,mtnplay.co.zm,mtnselfcare.co.zm,mtn.zm
Mujs|mujs.com
Myndr|myndr.net,myndr.nl
Myntra|myntra.com
N26|tech26.de,n26.com
Narkasa|narkasa.com
Natur.com GmbH|natur.com
NCSC UK|ncsc.gov.uk
Netgear|netgear.com
New Relic|newrelic.com
Nextcloud|nextcloud.talk,nextcloud.com
Nextiva|nextiva.com,nextos.com
ngrok|ngrok.com,ngrok.io,ngrok-free.app,ngrok-free.dev,ngrok.app,ngrok.dev
Nike|nike.com,converse.com,nike.net
Ninja Kiwi|ninjakiwi.com,battles.tv,nkstatic.com,ninja.kiwi
Nokia|nokia.com
Nominet|nominet.uk,nominet.org.uk,nic.uk
NordVPN|nordvpn.com
NOS|nos.nl
Nozbe|nozbe.com
Nubank|nubank.com.br
Nutanix|nutanix.com
Oanda|oanda.com,oanda.jp,tms.pl,tmsbrokers.com,investmentuniversity.pl
Oasis Protocol Foundation|oasiscloud.io
Observu|observu.com
Octopus Deploy|octopus.com
Odoo|odoo.com
Offensive Security|offensive-security.com,exploit-db.com,kali.org,backtrack-linux.org
Okcoin|okcoin.com
Okta|oktapreview.com
OKX|okx.com
Ola|olacabs.com,olamoney.com,ola.foundation,olaskilling.in,olaelectric.in,mission-electric.in,ola.institute
OLX|olx.in,olx.co.za,olx.co.id,olx.com.pk
OMG Nepal|omgnepal.com
Omise|omise.co
On2it|on2it.net
OnePlus|oneplus.com,oneplus.in,oneplus.net,oneplus.cn,oneplusbbs.com,h2os.com,onepl.us,1plus.io,oxygenos.com,onepluscorp.cn
OneTrust|onetrust.com
Onfido|onfido.com
Onhir|onhir.gov
Open Technology Fund|opentech.fund,reset.tech
Open-Xchange|dovecot.org,powerdns.com,open-xchange.com
OpenMage|openmage.org
OpenSea|opensea.io
Openware|yellow.org
Oppo|oppo.com,oppo.cn,myoppo.com,opposhop.cn,coloros.com,nearme.com.cn,oppomobile.com,oppofind.com,heytap.com,heytapmobi.com,realme.com,realme.net,oppopay.com,keke.cn,myoas.com,oppoer.me,wanyol.com,heytapmobile.com,heytapdownload.com,heytapimage.com,finzfin.com,realmeservice.com,realmemobile.com,realmebbs.com,myoas.net,realmepaysa.com,realme.com.tw,oppodigital.com,oppodigital.pl,oppothai.com,oppostore.com,oppodvd.com
Optimizely|optimizely.com
Orion Labs|orionlabs.io
Oro|oroinc.com
OVH|ovh.com
OWASP ZAP|zaproxy.org
OYO|oyorooms.com
P2B Exchange|p2pb2b.com
Paddy Power Betfair|betfair.ro,betfair.se,paddypower.it,betfair.it,betfair.es,betfair.com,paddypower.com,betfair.exchange
PagerDuty|pagerduty.com
Palantir Public|palantir.com,palantir.tech,palantir.build,palantircloud.com,palantircloud.co.uk,palantirfoundry.com,palantirfoundry.co.uk,palantirfoundry.de,palantirfoundry.fr,palantirfoundry.com.au,palantirgov.com,foundrygov.com
Palo Alto Software|outpost.co,liveplan.com,bplans.com,mplans.com,paloalto.com,teamoutpost.com
Pandora|pandora.digital
Panther Labs|runpanther.io,runpanther.com
Parity|parity.io
Parrot Sec|parrot.sh
Pasls Store|zimisa.com,pasls.com
Passit|passit.io
Paymill|paymill.com
Paytm|paytm.com,paytm.in,paytmmall.com,paytmbank.com,paytmfirstgames.com,gamepind.com,paytmmoney.com,paytm.ca,paytmlabs.com,mypaytm.com
Personal Capital|pcapcloud.com
PGGM|pggm.nl
Picky Assist|pickyassist.com
PicsArt|picsart.studio
Ping Identity|pingone.com
Pinterest|pinterest.com
Pixiv|pixiv.net,booth.pm,vroid.com,pxv.pay
Plaid|plaid.com
PlanetHoster|planethoster.net,n0c.com,planethoster.com
Playtech|playtech.com
Polkalokr|polkalokr.com
Poloniex|poloniex.com
Pon-Cat|pon-cat.com
Porkbun|porkbun.com
Pornhub|pornhub.com,pornhubpremium.com
Port of Antwerp|c-point.be,portofantwerp.com
PortSwigger Web Security|portswigger.net,web-security-academy.net
Postmates|postmates.com
PostNL|postnl.nl,postnl.com,postnl.post
Premier Hero|premierhero.com
Priceline|rezserver.com,priceline.com,bookingholdings.com
ProtonMail|protonmail.com
ProtonVPN|protonvpn.com,protonvpn.ch
PUBG|pubg.com,pubgesports.com
PureVPN|purevpn.com
Python Cryptographic|cryptography.io,pyopenssl.org
Quantopian|dynoquant.com,quantopian.com,quantshack.com
Quizlet|quizlet.com
Qulture.Rocks|qulture.rocks
Quora|app.mobile,quora.com
Qwant|qwant.com
Rabobank|rabobank.nl,rabobank.com
Railto LLC|railto.com
Range|range.co
Rarible|rarible.com
RATELIMITED|ratelimited.me
Razer|razer.com
Razorpay|razorpay.com
Realogy|realogy.com,bhgre.com,century21.com,coldwellbanker.com,cbcworldwide.com,corcoran.com,era.com,sothebysrealty.com,nrtllc.com,trgc.com,leadrouter.com,cartus.com,cbintouch.com,myzap.com
RecargaPay|recarga.com,recargapay.com.br
Recorded Future|recordedfuture.com,therecord.media
Redbull|redbull.com,redbullmediahouse.com,redbullmusicacademy.com
Reddit|reddit.com,snooguts.net,redd.it,redditblog.com,redditmedia.com,redditstatic.com,redditgifts.com,reddituploads.com,redditinc.com,reddithelp.com,dubsmash.com
Redis|redislabs.com,redis.com
Redox|redoxengine.com
Redtube|redtube.com
REM-B Hydraulics|hydass.be,hydraulics-group.com,rem-b.com,remb.be,rembconnect.be
Remitano|remitano.com
Replyify|replyify.com
Republik AG|republik.ch
Research Gate|researchgate.net
ResMed|resmed.com,resmed.co.uk,resmed.mx,resmed.com.br,resmed.lat,resmed.com.au,resmed.sg,resmed.hk,resmed.ph,resmed.vn,resmed.de,resmed.fr,resmed.nl,resmed.no,resmed.pt,resmed.dk,resmed.ch,resmed.la,resmed.com.cn
REVE Antivirus|reveantivirus.com
Rewind|rewind.com,replay.sh
RGhost|rghost.net
Riot Games|riotgames.com
Rivian Automotive|rivian.com,rivianservices.com
Ro|ro.co,getroman.com,ropharmacy.com,myplenity.com,hellorory.com,modernfertility.com
Roblox|roblox.com,rbx.com
Rockset|rockset.com
Router|routerprotocol.com
Royal Bank of Scotland|rbs.com,rbs.co.uk,rbsdigital.co.uk
RubyGems|rubygems.org
RupiahToken|rupiahtoken.com
Salesforce|salesforce.com
Samsung Mobile|samsungmobile.com
Samsung TV|samsung.com
santos|santos.com
SAP Concur|tripit.com
Savedroid|savedroid.com
Scholar Fund|scholarfundwa.org,scholarfund.io
Scopely|scopely.io,scopely.com,withbuddies.com
Scraping Hub|scrapinghub.com,crawlera.com
SecNews|secnews.gr
SecurityScorecard|securityscorecard.io,securityscorecard.com
SEMrush|berush.com,semrush.com,labs-semrush.com,sellzone.com,semrush.net,semrushchina.cn,seoquake.com,hr-semrush.com,sellerly.com,seoab.io,scatec.io
Sendcloud|sendcloud.com
Shakepay|shakepay.com
ShapeShift|shapeshift.com
SHEIN|shein.com,shein.in,shein.tw,shein.se,shein.com.hk,shein.com.vn,shein.com.mx,shein.co.uk,romwe.com,romwe.co.in
Shipt|shipt.com
Shopclues|shopclues.com
Shopify|exchangemarketplace.com,shopify.com,shopifykloud.com
SHOPLAZZA|shoplazza.com,myshoplaza.com
Showmax|showmax.com,showmax.app
Sidefx|sidefx.com
sidn|sidn.nl
Silvergoldbull|silvergoldbull.ca,silvergoldbull.de,silvergoldbull.com,sgb.co,alterx.com
Simple|simple.com
Sketch App|sketch.com
Smartling|smartling.com,verbalizeit.com
Smartsheet|smartsheet.com
Smokescreen|smokescreen.io
SMTP2GO|smtp2go.com
Smule|smule.com
Socrata|test-socrata.com
Sony|sony.com
Sorare|sorare.com
SpaceX|starlink.com,starlinkisp.net
Spell|spell.run
Spokeo|spokeo.com,freepeopledirectory.com,spokeoaffiliates.com
Spotify|thenodbuysblack.com,enspotify.com,atspotify.com,masmexa.com,gimlet.design,backstage.io,spotify-library.com,spotifypodcastsummit.com,spotify.com,spotifyawards.com,issa.website,spotifyvault.com,secretgenius.com,sonalytic.com,whatisapushplaylist.com,howdoimakethisroadtripbetter.com,surprisinglyawesome.com,soundtrap.com,spotifyjobs.com,poddamnthatsfunny.com,geistguest.com,whycantigettosleep.com,reviewvault.com,spotify.net,imabandi.to,howamistillhungover.com,spotifyforpartners.com,spotifyonstage.com,whowebe.com,startuplistener.com,doesmydogmissme.com,mimusica2019.com,spotifycharts.com,spotifysoundcheck.com,howdoikeepthekidsbusy.com,justaddspotify.com,thesecrettovictory.com,byspotify.com,whatsgoingonintheworld.com,timetoplayfair.com,niland.io,equalizerproject.com,spotify-everywhere.com,ninemusesfestival.com,spotifyforcreatives.com,spotify.xxx,spotifystories.com,parcast.com,spotifyforbrands.com,gimletmedia.com,spotify.dev,spotifyresonate.com,everynoise.com,closetheplaygap.com,spotify-countrymatch.com,spotifycodes.com,spotifyforpodcasterssummit.com.br,whatsthedealwithasmr.com,withspotify.com,spotifyforvendors.com,play-portraits.com,blackhistoryisnow.com,whatswrongwithmysucculent.com,extraordinariesonthemic.com,spotify.design
Sprout Social|sproutsocial.com,getbambu.com,simplymeasured.com
StackPath|highwinds.com,maxcdn.com,maxcdn.net,serverdensity.com,stackpath.com,stackpath.dev,stackpath.net
Standard Bank|standardbank.co.za,standardbank.com,standardbank.co.ao,stanbicbank.co.bw,stanbicbank.com.ci,standardbank.cd,standardbank.co.sz,stanbicbank.com.gh,stanbicbank.co.ke,standardlesothobank.co.ls,standardbank.co.mw,standardbank.mu,standardbank.co.mz,standardbank.com.na,stanbicibtcbank.com,stanbicbank.co.tz,stanbicbank.co.ug,stanbicbank.co.zm,stanbicbank.co.zw,standardbank.com.br
Stanford University|stanford.edu
Starbucks|starbucks.com.cn,starbucks.com.sg,starbucksreserve.com,starbucks.br,starbucks.fr,istarbucks.co.kr,starbucks.de,mystarbucks.kr,starbucks.ca,teavana.com,starbucks.com,starbucks.jp,starbucks.co.jp,starbucks.co.uk,starbucks.cn,starbucks.com.br
Starling Bank Limited|starlingbank.com
Stellantis|driveuconnect.com,driveuconnect.eu
Streak|streak.com,mailfoogae.appspot.com
Stripo Inc|stripo.email
StrongDM|strongdm.com,sdm.network
Superbet|superbet.ro
Surf|surf.nl
Swapcard|swapcard.com
Sweatco Ltd|sweatco.app
Swiggy|swiggy.com
Swiss Post|post.ch
Swisscom|adunit.ch,adunit.tech,ajila.com,digital.deals,autosense.ch,blue-action.ch,blue-app.ch,blue-app.com,blue-cinema.ch,blue-cinemas.ch,blue-cinemas.com,blue-doku.ch,blue-doku.com,blue-entertainment.ch,blue-entertainment.com,blue-extra.ch,blue-extra.com,blue-family.ch,blue-family.com,blue-games.ch,blue-gaming.ch,blue-gaming.com,blue-goal.ch,blue-goal.com,blue-info.ch,blue-kino.ch,blue-kino.com,blue-league.ch,blue-league.com,blue-live.ch,blue-member.ch,blue-member.com,blue-news.ch,blue-ondemand.ch,blue-ondemand.com,blue-packages.com,blue-play.ch,blue-player.ch,blue-plus.ch,blue-ppv.ch,blue-ppv.com,blue-premium.ch,blue-serie.ch,blue-series.ch,blue-smarttv.ch,blue-smarttv.com,blue-sport.ch,blue-sports.ch,blue-streaming.ch,blue-streaming.com,blue-tv.ch,blue-vision.ch,blue-vod.ch,blue-xtra.ch,blue-xtra.com,blue-zoom.ch,blue.ch,blueaction.ch,bluecinema.ch,bluecinemas.ch,bluedoku.ch,blueentertainment.ch,bluefamily.ch,bluegames.ch,bluegaming.ch,bluegoal.ch,blueinfo.ch,bluekino.ch,blueleague.ch,bluemember.ch,bluenews.ch,blueondemand.ch,bluepackages.ch,blueplay.ch,blueplayer.ch,blueplus.ch,blueppv.ch,blueppv.com,bluepremium.ch,blueprodukte.com,blueretro.ch,blueserie.ch,blueserie.com,blueseries.ch,bluesmarttv.ch,bluesmarttv.com,bluesport.ch,bluesports.ch,bluestreaming.ch,bluetv.ch,bluevod.ch,cinebowling.ch,cinebowling.com,cinebowling.events,cinetrade.ch,first-lounge-cinema.ch,first-lounge.ch,firstlounge.ch,firstloungecinema.ch,jassfederal.ch,kino.movie,kinotheater.ch,kinotheaterag.ch,kit.ag,kitag.ch,kitag.com,kitagcinema.ch,kitagcinema.com,kitagcinemas.ch,kitagcinemas.com,sporttv.ch,sporttv.hockey,teleclub-sport.ch,teleclub-zoom.ch,teleclub.ch,teleclubnow.ch,teleclubplay.ch,teleclubsport.ch,teleclubsports.ch,teleclubzoom.ch,daura.ch,globalipaction.ch,glipac.ch,i-web.ch,jls.ch,jls.digital,ngti.nl,bluewin.ch,conextrade.com,curabill.ch,cura-med.ch,digitalassessment.ch,ealarm-safemode.ch,ealarmstarter.ch,evita.ch,h-net.ch,hcard.ch,helloclass.ch,idisign.ch,intswisscom.com,jlr-connect.ch,labnet.ch,mccip.ch,mdm-mobile.ch,medicalconnector.ch,medicalexchange.ch,medicalshare.ch,mucc-services.ch,mycloud.ch,paybillag.com,pwlan.ch,scbs.ch,scsstatic.ch,sctv.ch,securepop.ch,sinso.ch,smeoffer.ch,swisscloud.io,swisscom-alarm.ch,swisscom-flaechen.ch,swisscom-health.ch,swisscom-immobilien.ch,swisscom-learningcenter.ch,swisscom-printshop.ch,swisscom-sharespace.com,swisscom-tv.com,swisscomcloud.com,swisscom-mcc.ch,swisscom.ai,swisscom.ch,swisscom.com,swisscomras.ch,swissdigicert.ch,swisstrustdir.ch,swisstrustroom.ch,swisstrustroom.com,triamed.ch,volvo-online.ch,webtiser.ch,webtiser.com,wingo.ch,sbcdc.ch,sbcnms.ch,sbc-nms.ch,sbc-ticketing.ch,sbcstreams.ch,sbctv.ch,swisscombroadcast.com,swisscombroadcast.ch,viaas.ch,videoinsider.ch,openwt.com,openwt.io,openwt.net,swisscomdigital.tech,swisscomdigital.technology,swisscomdigitaltechnologies.com,swisscomdigitaltechnology.ch,swisscomdt.com,akupunkturvergleich.ch,apotheken-vergleich.ch,augenarztvergleich.ch,bestattungsvergleich.ch,bijouterie-vergleich.ch,bodenlegervergleich.ch,cateringvergleich.ch,coaching-vergleich.ch,coiffeurvergleich.ch,consultingvergleich.ch,digitalone.ch,directories.ch,directoriesdata.ch,druckereien-vergleich.ch,e-directories.ch,elektrikervergleich.ch,ernaehrungsberatungsvergleich.ch,etv.ch,fahrlehrervergleich.ch,fitnessstudio-vergleich.ch,floristvergleich.ch,fondue-vergleich.ch,fotografvergleich.ch,garage-vergleich.ch,gartenbauvergleich.ch,gu-vergleich.ch,hautarztvergleich.ch,immoverwaltungsvergleich.ch,informatikervergleich.ch,innenarchitektvergleich.ch,kinderarztvergleich.ch,kinderkrippen-vergleich.ch,kosmetikvergleich.ch,local.ch,localcities.ch,localsearch.ch,maler-gipser-vergleich.ch,massagevergleich.ch,metzgereivergleich.ch,multisource.ch,mycommerce.shop,nachhilfevergleich.ch,nagelstudiovergleich.ch,oeffentliches-verzeichnis.ch,optiker-vergleich.ch,osteopathievergleich.ch,pannenhilfevergleich.ch,pflegeheimvergleich.ch,physiotherapievergleich.ch,reinigungsfirmavergleich.ch,reisebuerovergleich.ch,renovero.ch,sanitaervergleich.ch,scdag.net,schreinervergleich.ch,search.ch,sospos.ch,sitefree.ch,swisslist.ch,tanzschulvergleich.ch,tennisclubvergleich.ch,tierarztvergleich.ch,umzugsfirma-vergleich.ch,veloshop-vergleich.ch,wellness-spa-vergleich.ch,websheep.com,yoga-pilates-vergleich.ch,swisscomstream.ch,zoon.ch,u-s-p.ch,united-security-providers.ch,worklink.ch,cablex.ch,itnetx.ch
Synack|synack.com
T-Mobile CZ|t-mobile.cz
Takealot|takealot.com
TD Bank|td.com
Tealium|tealium.com,tealium.net,tiqcdn.com
Telenet|9lives.be,base.be,telenet.be,telenethotspot.be,yelo.be,yeloplay.be
Teleport|goteleport.com,gravitational.com,teleport.dev,teleportinfra.sh,gravitational.co,gravitational.io
Tencent|qq.com,tencent.com,tenpay.com,dnspod.cn,weiyun.com
Ternoa|ternoa.network
The Standard|standard.com
The Walt Disney Company|thewaltdisneycompany.com,waltdisneystudios.com,disneyanimation.com,pixar.com,marvel.com,lucasfilm.com,disneyplus.com,espn.com,disney.com,disneyconnect.com,disneynow.com,startv.com,hotstar.com,fxnetworks.com,abc.com
Threema|threema.ch
Tinder|tinder.com,gotinder.com,tinderops.net,tstaging.com,tstaging.tools,tinderwebstaging.com
Tokopedia|tokopedia.net,tokopedia.com,tokopedia.id
TomTom|tomtom.com,teleatlas.com,tomtomgroup.com
Top Coder|topcoder.com
Top Echelon Software|topechelon.com
Torfs|torfs.be,rieker-shop.be,schoenentorfs.be,schoenentorfs.nl
Touch Incentive Marketing|touchincentive.com
Toyota|toyotacertified.com,toyotacertificados.com,trdusa.com,toyotamobility.com,tddsprogram.com
Trade Republic|traderepublic.com
Traveloka|traveloka.com
Treebal|treebal.green
Trellix VDP|trellix.com,skyhighsecurity.com
Trendyol|trendyol.com,dolap.com
Trint Ltd|trint.com
Trustpilot|trustpilot.com
TTS Bug Bounty|data.gov,18f.gov,cloud.gov,search.gov,vote.gov,fedramp.gov,usa.gov,gsa.gov,code.gov,login.gov
TU Chemniz|tu-chemniz.de
Tube8|tube8.com,tube8.es,tube8.fr
Tumblr|tumblr.com,txmblr.com,umblr.com
Tutanota|tutanota.com,tutanota.de,tutamail.com,tuta.io,keemail.me
Tweakers|tweakblogs.net,tweakers.net,tweakimg.net
Twilio|authy.com,twilio.com
Twitter|mopub.com,pscp.tv,periscope.tv,niche.co,twitterflightschool.com,twimg.com,vine.co,twitter.com,gnip.com,snappytv.com
Tyk|tyk.io
U.S Social Security Administration|ssa.gov,segurosocial.gov,socialsecurity.gov
U.S. Dept Of Defense (DoD)|dspo.mil,yellowribbon.mil,afirm.mil,af.mil,afpims.mil,africom.mil,ah.mil,ai.mil,amaro.mil,arlingtoncemetery.mil,cac.mil,capmed.mil,centcom.mil,cto.mil,darpa.mil,dau.mil,dc3.mil,dcaa.mil,dcma.mil,dcoe.mil,dcsa.mil,dds.mil,defenseinnovationmarketplace.mil,deps.mil,dfas.mil,dhra.mil,dia.mil,dimoc.mil,disa.mil,dla.mil,dma.mil,dod.mil,doded.mil,dodig.mil,dodlive.mil,dodtap.mil,dodtechipedia.mil,dpaa.mil,dren.mil,dsca.mil,dss.mil,dtic.mil,dtra.mil,dtsa.mil,eb.mil,esgr.mil,esi.mil,eucom.mil,freedomaward.mil,health.mil,hpc.mil,inherentresolve.mil,iot.mil,jcs.mil,jcse.mil,jecc.mil,jfcom.mil,jieddo.mil,jsf.mil,jten.mil,jtj.mil,mail.mil,marines.mil,mc.mil,mda.mil,metc.mil,militaryonesource.mil,milsuite.mil,move.mil,nationalguard.mil,navy.mil,ng.mil,nga.mil,nipr.mil,norad.mil,northcom.mil,osd.mil,pacom.mil,pentagon.mil,pfpa.mil,sapr.mil,sigar.mil,soc.mil,socom.mil,southcom.mil,stratcom.mil,tricare.mil,uscg.mil,usfk.mil,usmc.mil,ustranscom.mil,warriorcare.mil,whs.mil,apps.mil,asbca.mil,budget.mil,cap.mil,cloud.mil,code.mil,crmforce.mil,cyber.mil,cybercom.mil,defense.mil,defenseculture.mil,defenselink.mil,deomi.mil,dib.mil,dispo.mil,diu.mil,dodcui.mil,dodmantech.mil,dodsbirsttr.mil,esgrevents.mil,hacc.mil,hci.mil,itnc.mil,jb.mil,jbsa.mil,jcu.mil,mysymptoms.mil,nicbr.mil,nro.mil,nsin.mil,opa.mil,repi.mil,sofsa.mil,spaceforce.mil,tapevents.mil,unc.mil,usuhs.mil,web.mil
U.S. Dept of Health & Human Services (HHS)|acl.gov,agingstats.gov,aids.gov,cdc.gov,cms.gov,cuidadodesalud.gov,donaciondeorganos.gov,fitness.gov,foodsafety.gov,girlshealth.gov,grantsolutions.gov,health.gov,healthdata.gov,healthfinder.gov,healthypeople.gov,hhs.gov,hiv.gov,hrsa.gov,insurekidsnow.gov,medicaid.gov,medicare.gov,mymedicare.gov,nih.gov,organdonor.gov,simplereport.gov,stopbullying.gov,womenshealth.gov
Ubiquiti|ubnt.com,ui.com
Udemy|udemy.com
UK Ministry of Defence|mod.uk,mod.gov.uk
Umbraco|umbraco.com
Unikrn|unikrn.com,pinion.gg,unikoingold.com
Upgrade|upgrade.com
UpHabit|uphabit.com
Uphold|uphold.com
UPS VDP|ups.com
Upserve|d2evh2mef3r450.cloudfront.net,swipely.com,vulnerbug.com,breadcrumb.com,upserve.com
Upstox|upstox.com
Upwork|upwork.com
Urban Company|urbancompany.com,urbanclap.com
Urban Dictionary|udimg.com,urbandictionary.com,urbanup.com,urbandictionary.net,urbandictionary.org,urbandictionary.store,ud.wtf,urbandictionary.biz,urbandictionary.blog
USAA|usaa.com
Valve Software|teamfortress.com,playartifact.com,counter-strike.net,dota2.com,steamcommunity.com,valvesoftware.com,steamgames.com,steampowered.com
Vanilla|vanilladevelopment.com,vanillacommunities.com,vanillaforums.com,vanillastaging.com,vanillacommunity.com
Varonis VDP|varonis.com,varonis.io
Vercel|vercel.com,now.systems,zeit-cdn.net,vercel.sh,zeit.sh
VGZ|vgz.nl
Vimeo|vimeopro.com,vimeo.com,vhx.tv
VirtuSwap|virtuswap.io
Visma Public|visma.com,vismaonline.com,workbox.dk
Vista|vista.co,vista.co.nz,veezi.com,movieteam.co
Vivo|vivo.com,vivo.xyz,vivo.cn
Vivy|vivy.com
VNG|vng.nl,ondernemersfondsen.nl
VOLKIS|volkis.com.au,volk.is
VRT|canvas.be,dewarmsteweek.be,ketnet.be,klara.be,mnm.be,radio1.be,radio2.be,radioplus.be,sporza.be,stubru.be,vrt.be
Walla! Communication|walla.co.il
Walmart Corporation|walmart.com
Wealthsimple|wealthsimple.com,simpletax.ca
WEB.DE|web.de,gmx.de,mail.com
Weblate|weblate.org
Wedbio|wedbio.com
Western Digital|westerndigital.com,wd.com
Western Union|westernunion.at,westernunion.ie,westernunion.de,westernunion.co.uk,westernunion.com.au,westernunion.co.nz,westernunion.fr,westernunion.no,westernunion.es,westernunion.ca,westernunionbank.com,westernunion.dk,westernunion.it,westernunion.nl,westernunion.pt,westernunion.com,westernunion.ee,westernunion.se,westernunion.fi,westernunion.pl,westernunion.ch,westernunion.gr,westernunion.be,westernunion.lu,wuedge.com
WhiteBIT|whitebit.com
Wickr|wickr.com
Windstream|orderwindstream.com,windstreamoffers.com,windstreamsmallbusiness.com,getwindstream.com,windstreamdeals.com,broadviewnet.com
WINNI|winni.in
Wombat Exchange|wombat.exchange
Woodpecker|woodpecker.co
WordPress|wordcamp.org,wordpress.net,bbpress.org,doaction.org,buddypress.org,wordpress.org,wordpressfoundation.org
Worklytics|worklytics.co
WP Engine|studiopress.blog,wpengine.com,wpengine.io,wpesvc.net,studiopress.com
Xiaomi|mi.com,miui.com,xiaomiyoupin.com,miwifi.com,global.shop,xiaomi.market,xiaomi.com
Y Combinator|startupschool.org,workatastartup.com,ycombinator.com
Yahoo!|techcrunch.com,makers.com,engadget.com,rivals.com,buildseries.com,yahoo.com,protrade.com,builtbygirls.com,yimg.com,flurry.com,ryot.org,autoblog.com,aol.com,verizondigitalmedia.com,aol.fr,aol.de,aol.co.uk,aol.jp,aol.in,aol.ca,aolpublishers.com,compuserve.com,netscape.com,wmconnect.com,getnetscape.com,vzbuilders.com,oath.cloud,yahoo.cloud,yahooapis.com
Yandex|yandex.ru,yandex.com,yandex.com.tr,yandex.kz,yandex.ua,yandex.by,yandex.st,yandex.net,ya.ru,yandex-bank.net,kinopoisk.ru,auto.ru
Yatra|yatra.com
Yelp|yelp.com,yelpwifi.com,yelp-support.com,yelpreservations.com,nowait.com
YesWeHack|yeswehack.com
YNAB|youneedabudget.com
Yuga Labs|boredapeyachtclub.com,yuga.com,yugalabs.io,otherside.xyz,meebits.app,cryptopunks.app,mdvmm.xyz
Zapier|zapier.com
Zendesk|zendesk.com,smooch.io,zopim.com
Zenly|znly.co,zen.ly
Zerodha|zerodha.com,kite.trade
Zilliqa|zilliqa.com,learnscilla.com
Zivver|zivver.com,zivvermeet.com
Zoho|site24x7.com,manageengine.com,qntrl.com,trainercentral.com,zoho.com
Zomato|zomato.com,zdev.net,zomatobook.com
Zoom|zoomtopia.com,meetzoom.us,zoom.com,vartopia.com,zoomdev.us,dev-zoom.us,zoomus.cn,keybase.io,zoomgov.com,wistia.com,zoompso.com,zoomasiaresourcehub.com,vartopia.info,zoomonprem.com,zoomsvr.com,zoomtopiastore.com,zoom.us
Zynga|zynga.com,zyngagames.com
FIS Global|fisglobal.com
